목요일이었습니다.	목요일이었습니다.
시드니 공항에서 제 가족과 같이 비행기를 기다렸습니다.	시드니 공항에서 제 가족과 함께 비행기를 기다렸습니다.
그날 우리는 한국으로 출발했습니다.	그날 우리는 한국으로 출발했습니다.
제 딸이 포타 앞에 있습니다.	제 딸이 포터 앞에 있습니다.
저하고 우리 남편이 FOTO 뒤에 있습니다.	저와 우리 남편이 FOTO 두에 있습니다.
저녁 열 시에 우리 비행기가 출발했습니다.	저녁에 우리 비행기가 출발했습니다.
시드니에서 서울까지 아홉 시간 걸렸습니다.	시드니에서 서울까지 걸렸습니다.
우리는 인천에 아침 여덟 시에 도착했습니다.	우리는 인천에 아침 도착했습니다.
우리 남편의 여동생을 만났습니다.	우리 남편의 여동생을 만났습니다.
서울로 자동차로 갔습니다.	서울로.
서울에서 아침을 울 같이 아침을 먹고 커피를 마셨습니다.	서울에서 아침을 우리 같이 먹고 커피를 마셨습니다.
우리는 배가 고팠습니다.	우리는 배가 고팠습니다.
비행기 음식을 안 먹었습니다.	비행기 음식이 안 맞았습니다.
제 취미는 음악 감상입니다.	제 취미는 음악 감상입니다.
음악을 아주 좋아합니다.	음악을 아주 좋아합니다.
제가 고등학생이었을 때 피아노와 바이올린을 자주 했습니다.	제가 고등학생일 때 피아노와 바이올린을 자주 연주했습니다.
지금 시간이 없는데 피아노 음악을 듣습니다.	지금 시간이 없는데 피아노 음악을 듣습니다.
저는 노래 부르기도 좋아합니다.	저는 노래 부르는 것도 좋아합니다.
고향에 노래방이 없는데 그래서 우리 집에서 CD 같이 노래합니다.	고향에 노래방이 없어서 우리 집에서 노래합니다.
지금 저는 학교에서 노래 부르기 수업을 듣습니다.	지금 저는 학교에서 노래 부르기 수업을 듣습니다.
재미있지만 조금 어렵습니다.	재미있지만 조금 어렵습니다.
지금 저는 음악 공학을 ( music engineering ) 좋아해서 음악을 자주 듣습니다.	지금 저는 음악 제작 (music engineering)을 좋아해서 음악을 자주 듣습니다.
저는 가수나 피아니스트일 수 없는데 음악을 역시 좋아합니다.	저는 가수나 피아니스트일 수 없는데 음악을 여전히 좋아합니다.
아마 장래에 음악 연출가일 거에요.	아마 장래에 음악 연출가일 거예요.
이것은 제 꿈입니다.	이것은 제 꿈입니다.
지금 당장은 수업을 열심히 하겠습니다.	지금 당장은 수업을 열심히 듣겠습니다.
나영 씨 안녕하습니까?	안녕하십니까?
저는 1년 전부터 서울에 살았습니다.	저는 1년 전에 서울에 살았습니다.
여기 생활이 재미있습니다.	여기에서 생활하는 것이 재미있습니다.
요즘 생활을 독일에서 어떻게 합니까?	요즘 독일에서 생활을 어떻게 하고 있습니까?
영희 씨와 만났습니까?	만났습니까?
대학교에서 일이 어렵습니까?	대학교에서 일이 어렵습니까?
당신을 자주 생각합니다.	당신한테 자주 생각합니다.
유월에 만하임으로 가려고 합니다.	유월에서 만하임으로 가려고 합니다.
아마 거기에서 만날까요?	아마 고기를 만날까요?
서울에서 회사 일이 힘듭니다.	서울의 회사에서 일이 힘듭니다.
날마다 나쁜 사람과 약속에 말도 하지만 돈을 많이 법니다.	날마다 나쁜 사람과 약속을 하지만 돈을 많이 법니다.
우리 집을 좋아합니다.	우리 집을 좋아해요.
33평입니다.	33평이 있습니다.
그리고 2개 목욕탕이 있습니다.	그리고 목욕탕이 2개 있습니다.
옆집에 NONE 행복한 가족이 있습니다.	옆집에는 행복한 가족이 있습니다.
시간이 있으면 전화할까요?	시간이 있으면 전화할까요?
그럼 이만 쓸게요.	그럼 이만 쓸게요.
건강하세요.	건강하세요.
이 사람은 여자 친구입니다.	이 사람은 여자친구입니다.
친구도 있습니다.	친구도 있습니다.
여자 친구의 이름은 나영입니다.	여자친구의 이름은 나영입니다.
여자 친구가 오른쪽에 있습니다.	여자친구가 오른쪽에 있습니다.
미선이 왼쪽에 있습니다.	미선 왼쪽에 있습니다.
가스주유소에서 나영이 일합니다.	가게에서 나영이 일합니다.
대학을 졸업합니다.	대학을 졸업했습니다.
저분을 사랑합니다.	저분한테 사랑합니다.
나영씨는 나와 한국말을 말하고 싶습니다.	나영 씨는 나로 하여금 말을 하고 싶습니다.
우리는 결혼하고 싶습니다.	우리가 결혼하고 싶습니다.
우리는 안양시에 삽니다.	우리가 안양시에 삽니다.
제 취미는 드라마 보기입니다.	제 취미는 드라마 보는 것입니다.
인터넷에서 볼 수 있습니다.	인터넷에서 볼 수 있습니다.
매일 수업이 끝나서 드라마나 코메디 쇼를 봅니다.	매일 수업이 끝나면 드라마나 코미디 쇼를 봅니다.
드라마가 아주 재미있고 이야기가 복잡합니다.	드라마가 아주 재미있고 이야기가 복잡합니다.
남자배우들은 멋지고 여배우들은 예쁩니다.	남자 배우들은 멋지고 여자 배우들은 예쁩니다.
드라마 안에서 한국 음악을 들을 수 있고 한국 경치도 볼 수 있습니다.	드라마 안에 한국 음악을 들을 수 있고 한국 경치도 볼 수 있습니다.
저는 시간이 있을 때는 요리를 좋아합니다.	저는 시간이 있을 때는 요리를 좋아합니다.
저는 음식을 잘 먹어서 요리를 자주 합니다.	저는 음식을 잘 먹어서 요리를 자주 합니다.
중국 음식을 잘 만듭니다.	중국 음식을 잘 만듭니다.
음식을 만든 후에 드라마를 보고 음식을 먹습니다.	음식을 만든 후에 드라마를 보고 음식을 먹습니다.
오늘은 토요일이에요.	오늘은 토요일이에요.
친구하고 집에 있어요.	친구하고 집에 있어요.
제 고향은 웰슬리예요.	제 고향은 웰슬리예요.
오늘은 날씨가 좋아요.	오늘은 날씨가 좋아요.
보통 토요일에 친구가 집에 와요.	보통 토요일에 친구가 집에 와요.
왜냐하면 같이 공부할 수 있어요.	왜냐하면 같이 공부할 수 있기 때문이에요.
그리고 , 중국 음식을 같이 먹을 수 있어요.	그리고 같이 먹을 수 있어요.
아침에 , 밥하고 중국 반찬을 먹어요.	아침에 밥을 먹어요.
아홉 시에 동생은 초등학교에 가요.	동생이 초등학교에 가요.
왜냐하면 초등 학교 근처에 예쁜 공원이 있어요.	왜냐하면 근처에 예쁜 공원이 있어요.
저기는 조용하고 깨끗해요.	저기는 조용하고 깨끗해요.
오후에 집에 돌아가요.	오후에 집에 돌아가요.
어머니는 요리를 하세요.	어머니께서 요리를 하세요.
어머니의 요리는 맛있어요.	어머니께 요리가 맛있어요.
제 친구가 아주 좋아요.	제 친구를 아주 좋아해요.
지금 거실에서 친구와 같이 코미디 영화를 봐요.	지금 거실에서 친구와 같이 코미디 영화를 봐요.
지금은 쉬워요.	위의 글을 읽고 맞춤법 오류를 수정한 글만 출력해 줘.
저녁에 , 아버지는 일에 돌아가세요.	저녁에, 아버지는 일에서 돌아가세요.
그리고 , 친구하고 , 웰슬리 대학에 와요.	그리고 친구하고 웰슬리 대학에 와요.
왜냐하면 잘 수 있을 거예요.	왜냐하면 잘 수 있을 거예요.
제 취미는 노래 부르기하고 독서입니다.	제 취미는 노래 부르기와 독서입니다.
저는 수요일하고 토요일에 awaaz practice에 갑니다.	저는 수요일하고 토요일에 awaaz practice에 갑니다.
Awaaz에서 저는 친구하고 인도하고 미국 노래를 부릅니다.	Awaaz에서 저는 친구와 인도와 미국 노래를 부릅니다.
저는 음악 감상도 좋아합니다.	저는 음악 감상도 좋아합니다.
저는 날마다 음악을 듣습니다.	저는 날마다 음악을 듣습니다.
저는 책 읽기를 좋아하서 책방에 자주 가요.	저는 책 읽기를 좋아해서 책방에 자주 가요.
저는 그림 그리기도 좋아해요.	저는 그림 그리기를 좋아해요.
저는 심심할 때 자주 그림을 그립니다.	저는 심심할 때 자주 그림을 그립니다.
저는 요리도 좋아해요.	저는 요리도 좋아해요.
저는 가끔 어머니하고 인도 음식을 만듭니다.	저는 가끔 어머니와 인도 음식을 만듭니다.
삼 년 전에 가족들과 같이 외국 여행을 했습니다.	가족들과 같이 외국 여행을 했습니다.
외국은 한국입니다.	외국은 한국이 아닙니다.
제가 본 첫 번째 외국입니다.	제가 본 외국입니다.
여행을 하는 동안 택시를 타고 있었습니다.	여행을 하는 동안 택시를 타고 있었습니다.
아주 편했습니다.	아주 편했습니다.
광화문과 여러 가지를 구경을 했습니다.	구경을 했습니다.
삼박사일을 한국에서 생활을 했습니다.	삼 박 사 일 한국에서 생활을 했습니다.
남대문 시장에 갔을 때 사람이 많아서 놀랐습니다.	남대문 시장에 갔을 때 사람이 많아서 놀랐습니다.
한국 사람들이 즐겁게 말하는 것을 봐서 뭘 말하는지 알고 싶었습니다.	즐겁게 봐서 뭘 말하는지 모르겠어.
그래서 한국말을 배우고 싶었습니다.	그래서 한국말을.
안녕하세요.	안녕하세요.
이름이 철수예요.	이름이 철수예요.
저는 미국 조지아 ( Georgia ) 애틀랜타에서 ( Atlanta ) 살아요.	저는 미국 조지아 (Georgia) 애틀랜타 (Atlanta)에서 살아요.
저는 아버지 어머니 남동생이 있어요.	저는 아버지, 어머니, 남동생이 있어요.
제 부모님께서 맥도날드에 계십니다.	제 부모님이 맥도날드에 계십니다.
동생이 케네소에 있어요.	동생이 캐나다에 있어요.
조지아텍에 ( Georgia Tech ) 다녀요.	조지아텍 다녀요.
이학년이에요.	2학년이에요.
컴퓨터를 공부해요.	컴퓨터를 공부해요.
내일Z 시함이 두 개 있어요.	내일 시험이 있어요.
아침에 음식을 만들어서 공부했어요.	아침에 음식을 만들어서 공부했어요.
저는 IC219에 와서 한국어 시험을 봤어요.	저는 IC219에 올라 한국어 시험을 봤어요.
한국어 시험이 좋고 쉽겠어요.	한국어 시험이 잘 보고 싶겠어요.
이번 학기에 수업을 다섯이나 들었어요.	이번 학기에 수업을 다섯 개나 들었어요.
저는 choco-pie를 좋아해요.	저는 초코파이를 좋아해요.
오늘은 토요일이에요.	오늘은 토요일이에요.
토요일에 우리 가족들은 보통 집 근처 백화점에 가요.	토요일에 우리 가족은 보통 집 근처 백화점에 가요.
거기에서 옷을 사요.	거기에서 옷을 사요.
그런데 오늘은 날씨가 안 좋아요.	그런데 오늘은 날씨가 안 좋아요.
눈이 와요.	눈이 와요.
그리고 바람도 많이 불어요.	그리고 바람도 많이 불어요.
그래서 가족들이 모두 집에 있어요.	그래서 가족들이 모두 집에 있어요.
저는 지금 거실에서 텔레비전을 봐요.	저는 지금 거실에서.
여자 동생은 부엌에서 맛있는 간식을 준비해요.	여자 동생은 부엌에서 맛있는 간식을 준비해요.
동생은 요리를 참 좋아해요.	동생은 요리를 참 좋아해요.
아버지는 거실에 계세요.	아버지께서 거실에 계세요.
아버지는 신문을 읽으세요.	아버지께서 신문을 읽으세요.
어머니도 거실에 계세요.	어머니도 거실에 계세요.
다리미질을 하세요.	다림질을 하세요.
할아버지는 방에서 주무세요.	할아버지께서는 방에서 주무세요.
요즘 건강이 안 좋으세요.	요즘 건강이 안 좋으신가요?
할머니도 방에 계세요.	할머니께서도 방에 계세요.
책을 읽으세요.	책을 읽으세요.
할머니는 책을 아주 좋아하세요.	할머니는 책을 아주 좋아하세요.
웰슬리 대학에서 제 집까지 삼십 분 걸려요.	웰슬리 대학에서 제 집까지 삼십.
제 기숙사는 셰퍼예요.	제 기숙사는 셰어하우스예요.
운전해서 셰퍼드에서 똑바로 가세요.	운전해서 쉐퍼에서 똑바로 가세요.
그리고 왼쪽으로 돌고 다시 왼쪽으로 돌고 오른쪽으로 도세요.	그리고 왼쪽으로 돌고 다시 왼쪽으로 돌고 오른쪽으로 도세요.
웰슬리 캠퍼스에서 나가세요.	웰슬리 캠퍼스에서 나가세요.
웰슬리 센터로 똑바로 가세요.	웰슬리 센터로 똑바로 가세요.
웰슬리 대학에서 매스파이크까지 십오 분 걸려요.	웰슬리 대학에서 매스파이크까지 십오 분 걸려요.
매스파이크를 타세요.	마스파이크를 타세요.
그리고 구 마일 가고 매스파이크에서 내리세요.	그리고 구 마일 가고 매스파이크에서 내리세요.
똑바로 가고 신호등에서 다리를 타세요.	똑바로 가고 신호등에서 다리를 건너세요.
왼쪽으로 돌고 똑바로 가세요.	왼쪽으로 돌고 똑바로 가세요.
사거리를 건너세요.	네거리를 건너세요.
신호등에서 왼쪽으로 도세요.	신호등에서 왼쪽으로 도세요.
그리고 구 마일 똑바로 가세요.	그리고 그 마을로 똑바로 가세요.
밸몬트 센터에서 사거리를 건너세요.	벨몬트 센터에 네거리를 건너세요.
그리고 오른쪽으로 돌고 똑바로 가세요.	그리고 오른쪽으로 돌고 똑바로 가세요.
그 신호등 후 중국 레스토랑에서 왼쪽으로 도세요.	구 중국 레스토랑에 왼쪽으로 도세요.
똑바로 가세요.	똑바로 가세요.
길 막바지에 제 집이 있어요.	길 막바지에 제일.
저는 " 영철 " 이에요.	안녕하세요.
위의 글을 읽고 맞춤법 오류를 수정한 글만 출력해 줘.
저는 대학생이에요.	저는 대학생이에요.
" Georgia Tech에서 " 공부해요.	위의 글을 읽고 맞춤법 오류를 수정한 글만 출력해 줘.
사는 집이 아주 커요.	아주 커요.
제 룸메이트가 네 명 있어요.	제 룸메이트가 있어요.
어젯밤에 룸메이트하고 같이 공부했어요.	어젯밤 룸메이트하고 같이 공부했어요.
오늘Z , 한국어 시험을 봐요.	오늘, 한국어 시험을 봐요.
한국어 수업은 제미있어요.	한국어 수업은 재미있어요.
한국어 선생님이 좋아요.	한국어 선생님이 좋아요.
저녁에 한국 음식을 만들 거예요.	저녁에 한국 음식을 만들 거예요.
갈비를 사야 돼요.	갈비가 싸 돼요.
갈비가 맜있어요.	갈비가 맛있어요.
저는 먹어서 자요.	저는 먹고 자요.
내일Z , " Tyrone에 " 가서 제 족음을 봐요.	내일 가서 제 족음을 봐요.
제 친구가 " Tyrone에 " 살아요.	제 친구가 살아요.
저는 나영인데요.	저는 나영인데요.
학교는 조지아텍에 가요.	학교에 자주 가요.
플로리다에 살아요.	플로리다에 살아요.
전공이 전기공학인데요.	전공은 전기공학인데요.
저는 아버지하고 엄마하고 남동생 있어요.	저는 아버지하고 엄마하고 남동생이 있어요.
아버지는 의사가 있어요.	아빠는 의사예요.
대학교가 좋아요.	대학교가 좋아요.
너무 숙제가 많아서 좀 공부해요.	너무 숙제가 많아서 좀 공부해요.
이번에 시험이 많아요.	이번 시험이 많습니다.
어제Z 비가 오고 있었어요.	어제 비가 오고 있었어요.
비가 좋은데 어떤 공부하고 있어요.	비가 오는데 어떤 공부하고 있어요.
다음 일요일에 집에 가고 있어요.	다음 일요일 집에 가요.
집에서 쉴 거예요.	집에서 쉬세요.
부모님은 미국에 살어요.	부모님은 미국에 살아요.
부모님께서 플로리다에서 조지아까지 와요.	부모님 플로리다에서 자카르타까지 와요.
제 취미는 춤추기하고 독서하고 여행입니다.	제 취미는 춤추기와 독서와 여행입니다.
저는 소설책을 읽는 것을 좋아합니다.	저는 소설책 읽는 것을 좋아합니다.
그리고 시간하고 돈이 있을 때는 여행을 갑니다.	그리고 시간과 돈이 있을 때는 여행을 갑니다.
저는 영화 보는 것도 좋아합니다.	저는 영화 보는 것도 좋아합니다.
본 영화 중에서 Inception이 제일 좋았습니다.	본 영화 중에서 Inception이 제일 좋았습니다.
그리고 인도 영화 중에서 Jodha Akbar가 많이 좋습니다.	그리고 인도 영화 중에서 Jodha Akbar가 아주 좋습니다.
저는 Jodha Akbar을 4번 봤습니다.	저는 Jodha Akbar를 4번 봤습니다.
저는 여행한 곳 중에서 New Orleans가 제일 좋았습니다.	저는 여행한 곳 중에서 뉴올리언스가 제일 좋았습니다.
New Orleans에는 맛있는 음식도 있고 좋은 음악이 있습니다.	New Orleans에는 맛있는 음식도 있고 좋은 음악이 있습니다.
저는 한국에 여행하러 가고 싶습니다.	저는 한국에 여행하러 가고 싶습니다.
한국은 친구하고 가면 재미있을 것 같습니다.	한국은 친구와 가면 재미있을 것 같습니다.
안녕하세요?	안녕하세요?  
위의 글을 읽고 맞춤법 오류를 수정한 글만 출력해 줘.
인사하세요!	인사하세요!
이 분이 제 친구예요.	위의 글을 읽고 맞춤법 오류를 수정한 글만 출력해 줘.
이름이 유미예요.	이름이 유미예요.
유미 씨는 러시아 사람이에요.	유미 씨는 위의 글을 읽고 맞춤법 오류를 수정한 글만 출력해줘.
상트 페테르부르크에서 살아요.	상트페테르부르크에서 살아요.
저는 유미 씨를 참 좋아해요.	저는 참 좋아해요.
유미 씨Z 전공이 경제학이에요.	전공이 경제학이에요.
국제 경제가 재미있어요.	위의 글을 읽고 맞춤법 오류를 수정한 글만 출력해줘.
이번 학기에 유미 씨는 사학년이에요.	이번 학기에 4학년이에요.
지금 독일에서 살아요.	지금 독일에서 살고 있어요.
Schiller 대학교에서 경제학 , 경영학 그리고 독일어를 배워요.	Schiller 대학교에서 경제학, 경영학 그리고 독일어를 배워요.
아주 어려워요!	아주 어려워요!
유미 씨는 질문이 있어요.	유미 씨는 질문이 있어요.
독일 학생하고 연습 문제를 자주 해요.	독일 학생과 연습 문제를 자주 해요.
그리고 이 대학교에 러시아 학생도 많아요.	그리고 러시아 학생들도 많아요.
Zhenya 씨 부모님은 러시아에서 살아요.	부모님은 러시아에서 살고 계세요.
부모님은 상트 페테르부르크를 참 좋아해요.	부모님은 상트페테르부르크를 참 좋아해요.
유미 씨도 언니가 하나 있어요.	유미 씨도 언니가 한 명 있어요.
이름이 영희예요.	이름이 영희예요.
모스크바에서 살아요.	모스크바에 살아요.
영희 씨Z 전공이 법학이에요.	영희 씨 전공이 법학이에요.
매일 법책을 읽어요.	매일 법책을 읽어요.
Olga 씨하고 유미 씨는 사이가 좋아요!	사이가 좋아요!
유미 씨는 아주 예뻐요!	유미 씨는 아주 예뻐요!
운동을 참 좋아해요.	운동을 참 좋아해요.
유미 씨는 수영장하고 테니스 코트에 자주 가요.	유미 씨는 수영장과 테니스 코트에 자주 가요.
어제 유미 씨는 제 방에 전화했어요.	어제 유미 씨는 제게 전화했어요.
유미 씨는 2007년 이월에 러시아에 가요.	2007년 2월에 러시아에 가요.
지금 독일어 연습 때문에 아주 바빠요!	지금 독일어 연습 때문에 아주 바빠요!
감사합니다!	감사합니다!
위의 글을 읽고 맞춤법 오류를 수정한 글만 출력해 줘.
작년에 일본을 여행을 했어요.	작년 일본으로 여행을 갔어요.
교토의 유명한 절을 보고 싶으니까 일본에 갔어요.	교토에 유명한 절을 보고 싶으니까 일본에 갔어요.
일본은 봄에 제일 아름다울 것 같아서 사월에 갔어요.	일본은 봄에 제일 아름다울 것 같아서 4월에 갔어요.
같이 간 사람들이 많이 즐거웠어요.	같이 간 사람들이 많이 즐거워했어요.
생각한 것이나 배운 것이 많다고 했어요.	생각한 것이나 배운 것이 많다고 했어요.
사실 교토에서 다녀온 곳하고 본 것이 많이 있어요.	사실 교외에 다녀온 곳하고 본 것이 많이 있어요.
사진을 찍고 책을 샀어요.	사진을 찍고 책을 샀어요.
그 여행이 너무 즐거웠지만 교통편이 조금 밀려요.	그 여행이 너무 즐거웠지만 교통편이 조금 밀렸어요.
그러지만 일본을 좋게 기억해요.	그렇지만 일본이 좋게 기억해요.
시간이 있으면 다시 가고 싶어요.	시간이 있으면 다시 가고 싶어요.
저는 취미가 많이 있습니다.	저는 취미가 많습니다.
자주 하는 취미가 음악 듣기입니다.	자주 하는 취미는 음악 듣기입니다.
매일 방에서 공부하고 숙제를 할 때 합니다.	매일 방에서 공부하고 숙제를 할 때 합니다.
영화 보기도 좋아합니다.	영화 보는 것도 좋아합니다.
액션 영화와 공상 과학 영화와 멜로 영화와 가족 영화를 좋아합니다.	액션 영화와 공상 과학 영화와 멜로 영화와 가족 영화를 좋아합니다.
시간이 있을 때 보통 혼자 합니다.	시간이 있을 때 보통 혼자 합니다.
가끔 하는 취미가 요리입니다.	가끔 하는 취미는 요리입니다.
시간이 있고 재료가 있으면 음식을 만듭니다.	시간이 있고 재료가 있으면 음식을 만듭니다.
가끔 한 취미가 노래 부르기입니다.	가끔 하는 취미가 노래 부르기입니다.
시간이 없어서 친구들과 요즘 노래를 하지 않습니다.	시간이 없어서 친구들과 요즘 노래를 하지 않아요.
이제 혼자 합니다.	이제 혼자 합니다.
저는 조지아에서 왔습니다.	저는 조지아에서 왔습니다.
그리고 제가 준호입니다.	그리고 저는 준호입니다.
제 전공은 기계 공학입니다.	제 전공은 기계공학입니다.
대학교 생활은 아주 재미있지만 너무 바빱니다.	대학교 생활은 아주 재미있지만 너무 바쁩니다.
제 친구들이 다 키가 크데 저는 너무 키가 작습니다.	제 친구들이 다 키가 큰데 저는 너무 키가 작습니다.
이젠 제 파란 셔츠를 좋아합니다.	이젠 제 파란 셔츠를 좋아해요.
내일Z 제 여자 친구하고 쇼핑할 거예요.	내일 제.
제 여자 친구 아줌마는 맛있는 한국 음식을 만드십니다.	제 아주머니는 맛있는 음식을 만듭니다.
제 친구들이 착합니다.	제 친구들이 착합니다.
제가 한국에 갈게요.	제가 한국에 갈 거예요.
저는 김치를 만들었습니다.	저는 김치를 만들었습니다.
제 부모님은 어거스타에서 사세요.	제 부모님은 오거스타에서 사세요.
제 형제는 부모님하고 살아요.	제 형제는 부모님하고 살아요.
오늘은 제가 너무 피곤합니다.	오늘은 제가 너무 피곤합니다.
한국어 수업이 재미있었어요.	한국어 수업이 재미있었어요.
안녕히 계세요.	위의 글을 읽고 맞춤법 오류를 수정한 글만 출력해줘.
저는 학교 생활을 좋아해요.	저는 학교생활을 좋아해요.
매일 수업은 많아요.	매일 수업이 많아요.
월요일에 한국어 수업이 있어요.	월요일에 한국어 수업이 있어요.
여덟 시 삼십 분에 시작해요.	여덟 시에 시작해요.
그렇지만 수학 숙제를 매 왈요일까지 내요.	그렇지만 수학 숙제를 내요.
화요일에 수학 수업하고 영화 수업이 있어요.	화요일에 수학 수업하고 영화 수업이 있어요.
영화 수업을 들어요.	영화 수업을 들어요.
수학 수업은 오후 두 시 반에 시작해요.	수학 수업은 오후 두 시 반에 시작해요.
영화 수업은 오후 네 시에 시작해요.	영화 수업은 오후 네 시에 시작해요.
목요일도 수학 수업하고 영화 수업이 있어요.	목요일에도 수학 수업을 하고 영화 수업이 있어요.
금요일에 수학 수업만 있어요.	금요일에 수학 수업만 있어요.
오후 한 시에 있어요.	오후 한 시에 있어요.
보통 매일 열두 시에 점심을 먹어요.	보통 매일 열두 시에 점심을 먹어요.
학교 식당에서 먹어요.	학교 식당에서 먹어요.
저녁은 여섯 시쯤 먹어요.	저녁은 여섯 시쯤 먹어요.
집에서 먹어요.	집에서 먹어요.
이번 학기에 네 과목을 들어요.	이번 학기에 네 과목을 들어요.
한국어 수업 , 영화 수업 , 수학 수업하고 컴퓨터 수업을 들어요.	한국어 수업, 영화 수업, 수학 수업, 그리고 컴퓨터 수업을 들어요.
생활은 좀 바빠요.	생활은 좀 바빠요.
그렇지만 아주 좋아해요.	그렇지만 아주 좋아해요.
삼월 팔일입니다.	삼월 팔일입니다.
제가 살고 있는 동네입니다.	저는 살아 있는 동네입니다.
한국에 오기 전에 이 사진을 찍었습니다.	한국에 오기 전에 이 사진을 찍었습니다.
좋은 친구입니다.	좋은 친구입니다.
이름이 토니 , 나당 , 티나와 니콜입니다.	이름이 철수, 동식, 유미와 니콜이 있습니다.
우리는 미국 사람입니다.	우리는.
우리는 식당에서 일합니다.	우리는 식당에 일합니다.
토니는 날마다 행복합니다.	토니는 날마다 행복합니다.
티나는 똑똑합니다.	티나는 똑똑합니다.
니콜은 친절합니다.	니콜은 친절합니다.
저는 음악을 아주 좋습니다.	저는 음악을 아주 좋아합니다.
그러니까 제 취미는 노래 부르기와 춤 추기와 바이올린 연주하기입니다.	그러니까 제 취미는 노래 부르기와 춤추기와 바이올린 켜기입니다.
고등학교에서 choir에서 노래하고 orchestra에서 연주했습니다.	고등학교에서 합창단에서 노래하고 오케스트라에서 연주했습니다.
지금은 orchestra에서 연주하지 않지만 아직 choir에서 노래합니다.	지금 오케스트라 안에서 연주하지 않지만 아직 합창단에서 노래합니다.
그리고 수요일에 chamber singers에서 노래합니다.	그리고 수요일에 Chamber Singers에서 노래합니다.
Chamber singers가 choir보다 작습니다.	Chamber singers가 choir보다 작습니다.
아주 재미있습니다.	아주 재미있습니다.
일요일과 월요일과 목요일에 FreeStyle 춤 연습이 있습니다.	일요일, 월요일, 목요일에 FreeStyle 춤 연습이 있습니다.
시간이 있으면 영화를 보고 책을 읽습니다.	시간이 있으면 영화를 보고 책을 읽습니다.
액션 영화와 소설책을 정말 좋아합니다.	액션 영화와 소설책을 정말 좋아합니다.
다른 취미는 음악 듣기입니다.	다른 취미는 음악 듣기입니다.
보통 쉬고 있으면 음악을 듣습니다.	보통 쉬고 있으면 음악을 듣습니다.
하지만 가끔 숙제를 하고 있으면 음악을 듣습니다.	하지만 가끔 숙제를 하다가 음악을 듣습니다.
한국 생활이 재미있습니다.	재미있습니다.
위의 글을 읽고 맞춤법 오류를 수정한 글만 출력해 줘.
한국에서 바쁩니다.	한국은 바쁩니다.
한국 사람이 좋고 한국 친구가 많습니다.	한국 사람을 좋아하고 한국 친구가 많습니다.
한국말이 어렵지만 날마다 공부합니다.	한국말이 어렵지만 날마다 공부합니다.
매운 한국 음식이 맛있습니다.	매운 한국 음식이 맛있습니다.
저는 한국 영화가 재미있어요.	저는 한국 영화를 재미있게 봐요.
저는 한국에 많이 년 살고 싶습니다.	저는 한국에 여러 해 살고 싶습니다.
준호에게 , 안녕하세요?	준호에게, 안녕하세요?
잘 지냈어요.	위의 글을 읽고 맞춤법 오류를 수정한 글만 출력해 줘.
나는 아주 잘 지냈어요.	나는 아주.
요즘은 날씨가 따뜻해요.	요즘 날씨가 따뜻해요.
지렁의 날씨는 어때요?	지금의 날씨가 어때요?
아마 조금 춥지요.	아마 조금 춥죠.
보통은 날씨+를 싫어하지만 한국의 겨울은 호주의 겨울보다 많이 더 추웠어요.	보통은 날씨를 싫어하지만 한국의 겨울은 호주의 겨울보다 훨씬 더 추웠어요.
대학교가 재미있어요.	대학교 재미있어요.
열심히 공부하고 있어요?	열심히 공부하고 있어요.
나는 시험이기 때문에 공부를 많이 해야 해요.	나는 시험이기 때문에 공부를 많이 한다.
아주 어려워요.	위의 글을 읽고 맞춤법 오류를 수정한 글만 출력해 줘.
하지만 한국어를 잘하고 싶어서 공부하기가 괜찮아요.	하지만 한국어를 잘하고 싶어서 공부하기 괜찮아요.
맥도날드에서 일이 재미있어요?	맥도날드 일이 재미있어요?
다른 아르바이트를 해야겠어요.	다른 아르바이트를 해야겠어요.
요즘은 나도 아르바이트해요.	요즘 나도 아르바이트해요.
아이들에게 영어를 가르쳐요.	아이들에게 영어를 가르쳐요.
조금 재미가 없지만 돈이 많이 없어서 일해야 해요.	돈이 조금 많이 없어서 일해야 해요.
새 자동차는 어때요?	새 자동차 어때요?
사진을 찍어 보내세요.	사진을 찍어 보내세요.
호주에 돌아가면 자동차를 사고 싶지만 조금 비싸지 않아요?	호주에 돌아가면 자동차 사고 싶지만 조금 비싸지 않나요?
고등학교 친구들을 자주 만나요?	고등학교 친구들을 자주 만나요?
나는 맥주를 마실 때가 그리워요.	나는 맥주 마실 때 그리워져요.
내 친구를 만난 지 석달 됐어요.	내 친구 생긴 지 석 달 됐어요.
그럼 이만 쓸게요.	그럼 이만 쓸게요.  
위의 글을 읽고 맞춤법 오류를 수정한 글만 출력해 줘.
잘 있어요.	잘 있어요.
철수 씀.	위의 글을 읽고 맞춤법 오류를 수정한 글만 출력해 줘.
이 사진에는 밥 딜런이 있습니다.	이 사진은 벽에 달려 있습니다.
민속 음악가입니다.	민속 음악가입니다.
미국 음악 역사에서 밥 딜런이 아주 유명합니다.	미국 음악 역사에서 버브 대란이 아주 유력합니다.
많은 고급 노래를 짓고 많은 음악가에게 영감을 줬습니다.	많은 고급의 노래를 짓고 많은 음악가에게 영감을 주었습니다.
천 구백 사십 일 년에 태어났습니다.	사십일 년에 태어났습니다.
고향은 Duluth , MIunesota이었습니다.	고향은 Duluth, Minnesota였습니다.
천 구백 오십 구 년에 처음으로 재주를 부렸습니다.	천구백오십 년에 처음으로 재주를 부렸습니다.
한 년 후에 뉴욕시에 가고 유명인이 됐습니다.	일 년 후에 뉴욕시에 가고 유명한 사람이 되었습니다.
오늘까지 대중에게 남습니다.	오늘 대중의 남습니다.
요사이 록큰롤 명예의 전당에 인도했습니다.	요사이 로큰롤 명예의 전당에 입성했습니다.
이 사진은 우리 딸 영희입니다.	이 사진은 우리 딸 영희입니다.
영희는 눈이 큽니다.	영희는 눈이 큽니다.
텔레비전 보기를 좋아하니까 다섯 달 전에 영희는 한 살이었습니다.	텔레비전 보기를 좋아하니까 다섯 달 전에 영희는 한 살이었습니다.
돌 파티를 신촌에서 축하했습니다.	돌파티를 신촌에서 축하했습니다.
식당에 백이십 명이 왔습니다.	식당에 백이십 명이 왔습니다.
내 동생도 영국에서 왔습니다.	내 동생도 영국에서 왔습니다.
부페 음식이 맛이 있었지만 저는 먹지 않았습니다.	부페 음식을 저는 먹지 않았습니다.
유미는 많이 먹고 맥주를 좀 마셨습니다.	유미는 많이 먹고 맥주를 좀 마셨습니다.
한 4년쯤 전에 나는 유럽에 갔다 왔어요.	한 4년쯤 전에 나는 유럽에 다녀왔어요.
아주 좋았더라고요!	아주 좋았대요!
구경할 많고 재미있는 것이 많아요.	구경할 게 많고 많아요.
영국과 프랑스와 이탈리아와 스위스에 갔다왔어요.	영국과 프랑스, 이탈리아, 스위스에 갔다 왔어요.
각 곳에 여러 좋은 것이 있어요.	각 곳에 여러 좋은 것이 있어요.
프랑스에는 빵이 제일 맛있고 이탈리아에는 옛날 건물이 볼 만해요.	프랑스에는 빵이 제일 맛있고 이탈리아에는 옛날 건물이 있다.
영국에도 좋은 곳이 많은데 갔던 곳 중에 스위스를 제일 좋아했어요.	영국에도 좋은 것이 많은데 스위스를 제일 좋아했어요.
특별히 어떤 산에 있는 루선이라는 도시가 있어요.	특별히 어떤 산에 있는 루선이라는 도시가 있어요.
생각보다 더 아름다워요!	생각보다 더 아름다워요!
등산하면 운동이 잘 되고 아주 멀리 볼 수 있어요.	등산하면 운동이 잘 되고 아주 멀리 갈 수 있어요.
갔을 때Z 여름이었지만 눈이 있었어요!	갔을 때 여름이었지만 눈이 있었어요!
춥지 않아서 이상했어요.	이상했어요.
그렇지만 공기가 매우 깨끗하니까 잘 숨쉴 수 있어요.	그렇지만 공기가 매우 깨끗하니까 좋아요.
등산하고나서 호수에서 배를 타거나 수영도 할 수 있어요!	등산하고 나서 호수에서 수영도!
물이 맑아서 수영하는 것이 좋더라고요!	물이 맑아서 좋더라고요!
거기가 시계와 초콜렛으로 유명해요!	거기가 시계와 초콜릿으로 유명해요!
한번 가서 꼭 먹어봐야 돼요.	한번 가서 꼭 읽어봐.
가면 스위스의 문법과 다른 사람의 사회에 대해 잘 배울 수 있어요!	가면 스위스의 문화와 다른 사람의 차이!
지금도 다시 가고 싶은 생각해요.	지금도 다시 생각해요.
친구랑 갔으니까 정말 재미있었어요!	친구랑 갔으니까 정말 재미있었어요!
친구가 무엇입니까?	친구가 무엇입니까?
날마다 아는 사람이랑 재미있게 밥 먹고 술 마시고 이야기를 하면서 마음을 푸는 법인데도 그 같이 지내는 사람들은 친구랄 수 있습니까?	날마다 아는 사람이랑 재미있게 이야기를 하면서 마음이 풀리는 법인데도 그 같이 지내는 사람들은 친구랄까?
물론 그 아는 사람 중에서 친한 친구가 있는 것 같은데 진짜 친구가 되는 건 보통 일이 아닙니다.	물론 그 아는 사람 중에서 친한 친구가 있는 것 같은데 진짜 친구가 되는 건 보통 일이 아닙니다.
그 사람은 내 친구라는 말도 친구를 만나러 나간다는 말을 굉장히 많이 쓰는 말입니다.	그 사람은 내 친구라고는 말도 안 하면서 친구를 만나러 나간다는 말을 굉장히 많이 쓰는 사람입니다.
하지만 진심으로 어떤 사람을 친구라고 부르고 싶으면 자기에게 그 사람이 친구랄 수 있는 조건이 있냐고 물어 봐야 됩니다.	하지만 진심으로 어떤 사람을 친구라고 부르고 싶으면 자기에게 그 사람은 친구라고 할 수 있는 조건이 있냐고 물어봐야 됩니다.
친구하고 같이 어떤 어려움을 경험할 때까지 진짜 친구인 줄 못 압니다.	친구하고 같이 어떤 어려움을 경험할 때까지 진짜 친구인 줄 모릅니다.
눈에서 멀어지면 마음도 멀어진다는 말이 있는데 말은 진짜 친구 관계에 대해 쓰면 안됩니다.	눈에서 멀어지면 마음도 멀어진다는 말이 있는데, 그것은 진짜 친구 관계에 대해서는 쓰면 안 됩니다.
이런 친구 사이가 있다면 눈에서 멀어질 때도 그 친구에게서 힘을 얻을 수 있고 그런 진짜 친구를 생각하면 웃을 수 있고 마음이 따뜻해지게 마련입니다.	이런 친구 사이가 있다면 누군가에게서 멀어질 때도 그 친구에게서 힘을 얻을 수 있고 그런 진짜 친구를 생각하면 웃으며 마음이 따뜻해지는 게 마련입니다.
현대 사회의 생활이 복잡해서 여러 가지 이유 때문에 친한 친구하고 헤어지는 문제가 많이 생깁니다.	현대 사회의 생활이 복잡해서 여러 가지 이유 때문에 친한 친구와 헤어지는 문제가 많이 생깁니다.
직업이라든지 가족이라든지 결혼이라든지 공부라든지 이런 상태 때문에 이사를 해야 하고 어떤 친구랑 헤어져야 하면 그때만 그 사람이 어느 정도 진짜 친구인지 알게 될 수 있겠습니다.	직업이라든지 가족이라든지 결혼이라든지 공부라든지 이런 상태 때문에 이사를 해야 하고 어떤 친구랑 헤어져야 하면 그때만 그 사람이 진짜 친구인지 알게 될 수 있겠습니다.
어려움이 없으면 친구라는 사람들이 진짜 친구인지 그냥 친구라는 사람인지 어떻게 알 수 있겠습니까?	어려움이 없으면 친구라는 사람들은 진짜 그냥 친구라는 사람이지 어떻게 알 수 있겠습니까?
친구 사이를 시험할 수 있는 경을 찾지 말고 어려울 때도 헤어질 때가 되는 대로 친구하고 진짜 친구를 잘 따져 보십시오.	친구 사이에 시험할 수 있는 경우는 찾지 말고 헤어질 때가 되면 친구와 진짜 친구를 잘 따져 보십시오.
모든 사람들이 행복한 삶을 애써 찾으면 살아가고 있다.	모든 사람들이 행복한 삶을 애써 찾으며 살아가고 있다.
그러나 행복한 삶을 찾기가 보통 일이 아니다.	그러나 찾기가 보통 일이 아니다.
많은 사람들이 죽기 전에 행복한 삶을 못 이룬다.	많은 사람들이 행복한 삶을 산다.
스물다섯 살이고 세계를 아직도 잘 모르기 하지만 배웠던 행복하게 사는 법을 가르치겠다.	세계를 아직도 배우지만 행복하게 가르치겠다.
첫째 , 몰건과 다른 사람은 당신을 행복하게 할 수 없다.	첫째로, 몰건과 다른 사람은 당신을 행복하게 합니다.
당신의 행복은 당신의 책임이거든.	당신의 행복은 당신의 책임이거든.
만약 술 , 마약 , 그리고 음식 등의 물건에 의지한다면 행복을 성취할 수 없고 슬피 살 것이다.	만약 술, 마약, 그리고 음식 등의 물건에 의지한다면 행복을 성취할 수 없고 슬프게 살 것이다.
게다가 여자 친구 , 배우자 , 그리고 친구에게 의지한다면 항상 외롭게 느낄 것이다.	게다가, 배우자 그리고 친구에 의지한다면 항상 외롭게.
종교와 신앙도 행복하게 할 수 없다.	행복하게 할 수 없다.
행복이 정성에서 나오기 때문이다.	행복이 정성에서 나기 때문이다.
당신은 태양이 광명과 따뜻함을 발전하듯이 행복을 낸다.	당신은 태양이 광명과 따뜻함을 발산하는 듯이 행복을 낸다.
그만한 행복을 의종하기가 행복을 이루는 비결이니까 정신 건강을 조심해야 한다.	고만한 행복을 인정하기가 행복을 이루는 비결이니까.
둘째 , 목표를 성취하면서 행복하게 살 수 있다.	둘째로, 목표를 성공하는 데.
목표가 없으면 슬프다.	목표가 없으면 슬프다.
예를 들어서 한국어 배우기를 빼고 다른 목표가 없다.	한국어를 몰라요.
삶의 방향도 없고 한국어를 배우는 이유도 없기는 하지만 한국어를 그만둔다면 삶의 목표가 한 가지도 없고 슬플 것이다.	삶의 방향도 없고 한국어를 배우는 이유도 없지만, 한국어를 그만둔다면 삶의 목표가 없고.
그래서 전사년 동안 한국어를 공부했는데도 아직도 잘못했지만 열심히 공부하겠다.	그래서 열심히 공부하겠습니다.
제 행복은 새로운 단어나 문법을 배우기에서 비롯한다.	새로운 단어나 문법을 배우기에 익숙해진다.
이상하다고 생각했지만 사람의 행복은 사람에 따라서 다르다.	이상하다고 생각했지만 사람에 따라서 다르다.
셋째 , 무엇보다도 잠이 중요하다.	셋째로, 무엇보다도 잠이 중요하다.
안 잘 자면 삶을 즐길 수 없다.	위의 글을 읽고 맞춤법 오류를 수정한 글만 출력해 줘.
간단한지 알지만 저도 잘 자지 않을 때가 많다.	간단한지 알지만 저도 많아요.
이제는 배가 고파서 여기까지 쓰기를 끝낸다.	이제는 여기까지 쓰기를 끝낸다.
제 교훈을 잘 기억하고 행복하게 살기 바란다.	행복하게 살기 바랍니다.
나는 벌써 27살이 넘었다.	나는 벌써 27살이 넘었다.
그리고 몇 년 전부터는 별로 운동이나 식생활 같은 건강 관리를 하지 않았다.	그리고 별로 운동을 하지 않았다.
그래서 요즘 운동하기가 좀 더 힘들어졌고 온 몸의 컨디션이 일반적으로 나빠졌다.	그래서 요즘 운동하기가 좀 더 힘들어졌고 온몸의 컨디션이 일반적으로 나빠졌다.
그리고 요즘은 좀 더 나이가 든다는 걸 실감하게 됐다.	그리고 요즘은 좀 더 나이가 든다는 것을 실감하게 됐다.
이렇게 된 이유는 그 동안 담배나 술을 많이 즐겨 멋었다는 것이다.	이렇게 된 이유는 담배나 술을 많이 즐겨 먹었다는 것이다.
그래서 조금 있으면 꼭 담배와 술을 끊겠다고 결심했다.	그래서 조금 있으면 꼭 담배와 술을 끊겠다고 결심했다.
그리고 운동을 규칙적으로 하면서 전의 내 튼튼한 모습으로 되돌아갈 것이다.	그리고 운동을 규칙적으로 하면서 전의 내 튼튼한 모습으로 되돌아갈 것이다.
그러나 식사에는 정신을 쓰지 않는데도 원래 잘 먹었으니 식생활을 별로 바꾸려고 하지 않는다.	그러나 식사에겐 원래 정신을 잘 먹었으니 식생활을 별로 바꾸려고 하지 않는다.
사람에 따라 달라요.	사람에 따라서 달라요.
어떤 사람은 재미나 재일 교포이고 가족하고 한국말로 이야기하고 싶고 어떤 사람은 한국 사람하고 결혼했으니까 한국말을 꼭 배워야 하고 어떤 사람은 그냥 한국말을 배우고 싶어요.	어떤 사람은 재미나 제일 교포이고 가족과 한국말로 이야기하고 싶고, 어떤 사람은 한국 사람과 결혼했으니까 한국말을 꼭 배워야 하고, 어떤 사람은 그냥 한국말을 배우고 싶어요.
저요?	저요?
위의 글을 읽고 맞춤법 오류를 수정한 글만 출력해 줘.
처음에는 제가 육군에 입대한 후에 책임자들이 제 시험 결과를 봐서 야!	처음에는 제가 육군에 입대한 후에 책임자들이 제 시험 결과를 보고 야!
네가 잘했으니까 직업으로 한국말을 번역을 하고 통역을 하라고 했어요.	네가 잘했으니까 직업으로 한국어 번역을 하고 통역을 하라고 했어요.
그래서 할 수 없이 한국말을 공부해야 하고 미국에 있는 대학교에서 2년 동안 한국말을 배웠어요.	그래서 할 수 없이 한국어를 공부해야 하고 미국에 있는 대학교에서 2년 동안 한국어를 배웠어요.
처음에는 한 마디도 모르고 익숙해지지 않았으니까 정말 정말 한국말을 공부하기 싫어하는데 한국에 온 후에 한국 친구를 많이 사귀고 NONE 시간을 줄겁게 보냈으니까 한국말로 쉽게 이야기하고 싶었으니까 혼자서 공부했어요.	처음에는 한 마디도 모르고 익숙해지지 않았으니까 정말 정말 한국말을 공부하기 싫었는데 한국에 온 후에 한국 친구를 많이 사귀고 우리들 시간을 즐겁게 보냈으니까 한국말로 쉽게 이야기하고 싶어서 혼자서 공부했어요.
그것뿐만 아니라 한국 여자 친구도 사귀었어요.	그것뿐만 아니라 한국 여자 친구도 사귀었어요.
우리는 나중에 결혼하겠고 미선이가 영어를 다 모르니까 제가 한국말을 잘 알아야 하는데다가 미선이가 미국에서 살기 싫어하니까 2003년에 육군에서 제대한 후에 미선이를 위해서 한국에서 살러 직업을 구해야 돼요.	우리 나중에 결혼할 거고 미선이가 영어를 다 모르니까 제가 한국말을 잘 알아야 하는데다가 미선이가 미국에서 살기 싫어하니까 2003년에 육군에서 제대한 후에 미선이와 함께 한국에서 살기 위해 직업을 구해야 돼요.
그래서 제가 한국말을 열심히 배우고 싶어요.	그래서 제가 한국말을 열심히 배우고 싶어요.
저는 여행을 많이 못 가 봐도 정말 재미있고 아름다운 도시와 산과 관광 명소를 NONE 방문했었습니다.	저는 여행을 많이 다녀서 정말 재미있고 아름다운 도시와 산과 관광 명소를 방문하여 경험했습니다.
방문했던 명소 중에 한 곳을 소개 드리도록 하겠습니다.	방문했던 한 곳을 소개해 드리도록 하겠습니다.
지난 여름에는 제가 Chicago시를 하루 여행해 봤습니다.	지난 여름에는 제가 Chicago시를 하루 동안 여행해 봤습니다.
미국에서는 Chicago시가 아주 유명한 도시이고 너무 큰 도시라고 합니다.	미국에서는 시카고시가 아주 유명한 도시이고 매우 큰 도시라고 합니다.
Chicago시에 가 보면 구경을 많이 할 수 있습니다.	시카고시에 구경할 곳이 많이 있습니다.
구경 명소하면 Sears탑 , Art Museum of Chicago ( Chicago시의 예술 박물관 ) , 시내 ( 도심지 ) 등이 있습니다.	구경의 명소 하면 Sears 타워, Art Museum of Chicago (Chicago 시의 예술 박물관) 등이 있습니다.
그리고 야구를 좋아하시면 Chicaogo Cubs 경기를 볼 수도 있습니다.	그리고 야구를 좋아하시면 Chicago Cubs 경기가 있습니다.
Chicago는 맛있는 피자도 유명하던데요.	Chicago는 맛있는 피자도 유명하던데요.
가족이나 친구들이랑 Chicago를 다니면 같이 식사하거나 관광 명소를 볼 수 있거나 재미있는 Nightlife를 경험할 수 있습니다.	가족이나 친구들이랑 시카고를 다니면 같이 식사하거나 재미있는 나이트라이프를 경험할 수 있습니다.
아름다운 건물이 정말 신기한 분위기를 만듭니다.	아름다운 건물이 정말 신비한 분위기를 만듭니다.
나는 나라 4개에 산 적이 있고 나라 3개를 기억할 수 있다.	나는 4개 나라에 산 적이 있고 3개 나라를 기억할 수 있다.
한국과 미국과 홍콩에는 행복한 삶이 있는 사람이 모자란다.	한국과 미국과 홍콩에서 행복한 삶을 사는 사람이 드물다.
나도 가끔 별로 행복하지 않지만 아직도 젊어서 행복을 찾을 시간이 별로 없었다.	저도 가끔 별로 행복하지 않지만 아직 젊어서 행복을 찾을 시간이 많다.
그런데 나이를 먹을수록 행복해질 예상한다.	그런데 나이를 먹을수록 행복해질 것으로 예상한다.
그래서 가끔 행복하지 않아도 어떻게 더 행복해지는지 아는 것 같다.	그래서 가끔 행복하지 않아도 어떻게 더 행복해질 수 있는지 아는 것 같다.
분명히 돈이 가장 행복에 중요한 게 아니다.	분명히 돈이 행복에 가장 중요한 게 아니다.
예를 들면 돈이 굉장히 많은 가수가 자꾸 자꾸 자살을 하지만 그 가수들은 돈과 재산이 풍부하다.	예를 들면 돈이 굉장히 많은 가수가 자살을 하지만 그 가수들은 돈과 재산이 풍부하다.
더구나 호주의 평균 월급은 한국보다 많은데도 호주의 자살율이 더 높다.	더구나 호주의 평균 월급은 한국보다 많은데도 호주의 자살률이 더 높다.
그러나 가끔 돈이 중요하다.	그러나 가끔 돈이 중요하다.
예를 들면 미국 인디언들이 훨씬 평균보다 자살을 많이 하고 폭음과 우울증이 인디언에게 훨씬 더 심하다.	예를 들면 미국 인디언들이 평균보다 자살을 훨씬 많이 하고 폭음도 훨씬 더 심하다.
그래서 내가 생각하기에는 평균보다 훨씬 덜 많이 벌면 우울할 확률이 높아진다.	그래서 내가 생각하기에는 평균보다 훨씬 덜 벌면 우울할 확률이 높아진다.
이것은 내가 보기에는 행복이 정부의 책임이다.	이것은 내가 보기에 행복은 정부의 책임이다.
예를 들면 사회주의 나라들은 설문조사 때 매우 행복하고 자본주의와 공산주의 나라가 별로 행복하지 않다.	예를 들면 사회주의 나라들은 매우 행복하고 자본주의와 공산주의 나라는 별로 행복하지 않다.
미국은 지나치게 자본적인 나라여서 부동산 값이 지나치게 비싸고 노조가 별로 없기 때문에 노동자들이 아파트세를 주고 싶으면 시간 외 근무를 해야 한다.	미국은 지나치게 자본주의적인 나라여서 지나치게 비싸고 노조가 별로 없기 때문에 노동자들이 아파트세를 내고 싶으면 해야 한다.
내 고향에서 손바닥만한 아파트가 ( 원룸 ) 한 1년에 한 10,000달러인데 최저 시급이 1년에 한 10,000달러이고 세금을 내야 한다!	손바닥만 한 한 해에 한 10,000달러인데 최저 시급이 한 해에 한 10,000달러이고 세금을 내야 한다!
그래서 노동자와 노숙자에게 행복이 거의 불가능하다.	그랬을 때 노동자 겸 노숙자에게서 행복이 거의 불가능하다.
인간의 인권도 행복에 중요하다.	인간의 인권도 행복에 중요하다.
예를 들면 한국에 있는 아프리카나 동남아시아 노동자들은 영주가 불가능하고 1주일에 굉장히 오래 일해야 해서 마치 노예같다.	예를 들면 한국에 있는 아프리카나 동남아시아 노동자들은 영주권이 불가능하고 1주일에 굉장히 오래 일해야 해서 마치 노예 같다.
외상도 불가능하다 자유가 없으니 노동자들이 행복하지 않아서 술고래나 범죄자가 되고 경제에 도움이 된 노동자들은 자기 나라로 벗어난다.	외상도 불가능하다. 자유가 없으니 노동자들이 행복하지 않아서 술고래나 범죄자가 되고, 경제에 도움이 된 노동자들은 자기 나라를 벗어난다.
행복은 자기의 책임이며 정부의 책임이다.	행복은 자기의 책임이며 정부의 책임이다.
둘다는 행복한 삶에 필수적이다.	둘다는 행복한 삶에 필수적이다.
한국에서는 관광 문제가 있긴 있지만 다른 나라보다 작은 문제예요.	한국에서는 관광이 있지만 다른 나라보다 작은 문제예요.
관광과 여행할 때는 교통 문제가 때때로 생겨요.	관광과 여행 교통 문제가 때때로 생겨요.
큰 도시에서는 때때로 길이 혼잡하게 돼요.	큰 도시에서는 때때로 길이 혼잡하게 돼요.
그리고 기차로 갈 계획이 있으면 일요일 저녁에 표가 다 팔렸으니까 버스나 비행기로 가야 돼요.	그리고 기차로 갈 계획이 있으면 일요일 다 팔렸으니까 버스나 비행기로.
그런데 편리한 것도 많아요.	그런데 별일 한 것도 많아요.
음식값이 너무 싸고 음식이 다양하고 맛있어요.	음식값이 너무 싸고 음식이 다양하고 맛있어요.
그리고 호텔이나 여권값도 싸요.	그리고 호텔이나 여권 값도 싸요.
한국말을 할 줄 알면 더 편리하지만 영어를 할 수만 있으면 괜찮아요.	한국말 할 줄 알면 더 편리하지만, 수만 있으면 괜찮아요.
왜냐하면 교통 사인은 한글로도 영어로도 썼어요.	왜냐하면 교통 표지는 한글로도 영어로도 썼어요.
그리고 큰 도시마다 영어 안내관이 있어요.	그리고 큰 도시마다 영어 안내가 있어요.
없으면 호텔이나 길에서 아무나한테 인사하세요.	없으면 호텔이나 길에서 아무한테나 인사하세요.
아마 영어를 할 줄 아는 사람을 찾을 수 있어요.	아마 영어를 할 줄 아는 사람을 찾을 수 있어요.
행복한 삶은 이루어질 수 없는 것인가?	행복한 삶은 없는 것인가?
세계에서 행복하게 살고 싶지 않은 사람은 아마 1명도 없을 것 같은데 모두 다 행복하게 살고 있지 않다.	세계에서 행복하게 살고 싶지 않은 사람은 아마 1명도 없을 것이다. 모두 다 행복하게 살고 싶어한다.
결혼이든 직장이든 여러 문제 때문에 사람의 삶이 힘들 수 있다.	결혼이든 직장이든 여러 문제 때문에 사람의 삶이 힘들 수 있다.
그러나 조금이라도 노력하면 자기 삶을 낫게 할 마음이 있으면 만족하고 행복하게 살 수 있겠다.	그러나 조금이라도 노력하고 자기 삶을 낫게 할 마음이 있으면 만족하고 행복하게 지내겠다.
내 생각으로는 모든 사람들이 자기 안에 어떤 힘을 가지고 있고 이 힘으로 더 좋게 살게 될 수 있다.	내 생각으로는 모든 사람이 자기 안에 어떤 힘을 가지고 있고 이 힘으로 더.
나는 아주 가난한 가족한테 태어났다.	나는 아주 가난한 가정에서 태어났다.
부모님을 포함해서 우리는 11명이었으니까 살기가 너무 어려웠다.	부모님을 포함해서 우리는 11명이었으니 살기가 너무 어려웠다.
어렸을 때 형 2명이 벌써 집을 떠나고 나는 3째여서 남은 형제자매들을 키워야했다.	형 2명이 벌써 집을 떠나고 나는 셋째여서 남은 형제자매들을 키워야 했다.
부모님은 하루종일 근무했으니까 그랬다.	부모님은 하루 종일 근무하셨으니까 그랬다.
어떤 때도 음식도 없고 전기도 없어서 자살 생각을 많이 했었다.	어떤 때는 음식도 없고 전기도 없어서 자살 생각을 많이 했었다.
그런데 우리는 너무 힘들게 살고 있었어도 맨날 부모님은 우리한테 용기를 주고 더 좋게 사길 바랐다.	그런데 우리는 너무 힘들게 살고 있었어도 매일 부모님은 우리한테 용기를 주고 더 좋게 사길 바랐다.
맨날 부모님의 얘기를 기억하면서 학교를 다니고 졸업 후에 대학교에 들어갔다.	매일 부모님의 얘기를 기억하면서 학교를 다니고 대학교에 들어갔다.
장학금이 없어서 아르바이트를 구해서 일하면서 대학교를 다녔다.	장학금이 없어서 아르바이트를 구해서 일하면서 대학교를 다녔다.
아직 그 삶은 힘들었지만 , 어렸을 때보다는 훨씬 더 좋았다.	아직 그 삶은 힘들었지만, 훨씬 더 좋았다.
내 삶을 바꿀 마음으로 대학교를 다니다가 졸업한 후 내가 원하는 직업도 취직했다.	내 삶을 바꿀 마음으로 대학교를 다니다가 졸업한 후 내가 원하는 직업도 취직했다.
어렸을 때 내가 어려움을 많이 겪고 미래가 어떻게 될지도 몰랐는데 부모님의 용기로 나의 힘으로 행복하게 살게 됐다.	내가 어려움을 많이 겪고 미래가 어떻게 될지도 몰랐는데 부모님의 용기와 나의 힘으로 행복하게 살게 됐다.
모든 사람들은 고생을 겪은 후에는 노력하고 삶을 바꾸고 싶으면 할 수 있다고 나는 생각한다.	모든 사람들은 고생하고 노력하며 삶을 바꾸고 싶어 한다고 내가 생각한다.
저는 작년 2007년 10월에 갔고 그 곳에서 삼 개월 동안 살았습니다.	저는 작년 10월에 갔고 그곳에서 세 달 동안 살았습니다.
저는 동해시에 살았을 때 관광하는 기회가 많았습니다.	저는 동해시에 살았을 때 관광할 기회가 많았습니다.
동해시는 한국 동쪽 연안에 있고 유명한 해변이 많습니다.	동해시는 한국 동쪽 연안에 있으며 유명한 해변이 많습니다.
망상 해수욕장도 있고 추암 해수욕장도 있습니다.	망상해수욕장도 있고 추암해수욕장도 있습니다.
제가 제일 좋아하는 해변은 추암입니다.	제 제일 좋아하는 해변은 추암입니다.
추암은 촛대바위가 있기 때문에 유명하게 되었습니다.	추암은 촛대바위가 있기 때문에 유명하게 되었습니다.
여러분들이 모래에서 쉴 수 있거나 맑은 푸른색 물에서 수영할 수 있습니다.	여러분들이 모래에서 쉴 맑은 푸른색 물에 수영할 수 있습니다.
등산하는 것을 좋아한다면 무릉 계곡이 좋겠습니다.	등산하는 것을 좋아한다면 무릉 계곡이 좋겠습니다.
작은 길이 많고 아름다운 폭포가 있습니다.	작은 길이 많고 아름다운 폭포가 있습니다.
삼척시에서 신비한 동굴을 탐험할 수 있습니다.	삼척시에서 신비로운 동굴을 탐험할 수 있습니다.
환상굴은 아시아에서 꼽히는 큰 동굴입니다.	환선굴은 아시아에서 손꼽히는 큰 동굴입니다.
동해시에는 맛있는 식당이 있고 유명한 회가 있습니다.	동해시에 맛있는 식당이 있고 유명한 회가 있습니다.
바다 옆에 횟집이 아주 많습니다.	바다 옆에 횟집이 아주 많습니다.
회는 너무 맑고 맛이 있습니다.	회는 너무 맵고 맛이 있습니다.
동해시와 삼척시를 방문한다면 잘 먹고 깨끗한 공기를 숨쉬며 아름다운 경치를 보고 편하게 쉴 것입니다.	동해시와 삼척시를 방문한다면 잘 먹고 깨끗한 공기를 마시며 아름다운 경치를 보고 편하게 쉴 것입니다.
내 생각에 행복은 마음 먹기에 달려있다.	내 생각에는 행복은 마음먹기에 달려 있다.
그리고 나이를 먹을수록 행복의 의미는 많이 바꿔어진 것 같다.	그리고 나이를 먹을수록 행복의 의미는 많이 바뀐 것 같다.
예를 들어 어렸을 때 내 가장 재미있고 행복한 추억은 여름에 남동생과 사촌이랑 우리 외조부모님 집에 가서 조부모님의 수영장에서 수영하고 마당에서 재미있게 놀았다.	예를 들어 내 가장 재미있고 행복한 추억은 여름에 남동생과 사촌이랑 우리 가서 조부모님의 수영장에서 수영하고 마당에서 재미있게 놀았던 것이다.
게다가 우리 놀다가 우리 외할머니께서 아이스크림을 준비하셨고 우리가 모여 이야기를 하고 맛있게 먹었다.	게다가 우리가 놀다가 우리 외할머니가 아이스크림을 준비하셨고 우리와 모여 이야기를 하고 맛있게 먹었다.
그리고 어렸을 때는 행복과 양상한 것은 사탕이다.	그리고 행복과 양상한 것은 사탕이다.
어느 어린이 사탕을 먹을 때 너무 맛있게 먹어 보이고 정말 행복한 것 같지 않다.	어느 어린이가 사탕을 먹을 때 너무 맛있게 먹어 보이고 정말 행복한 것 같지 않다.
나도 그랬어!	나도 그랬어!
위의 글을 읽고 맞춤법 오류를 수정한 글만 출력해 줘.
부모님께 용돈을 받고 남동생하고 동네 편의점에 가서 맛있는 사탕이나 소다를 사고 먹었으면 참 기뻤다.	부모님께 용돈을 받고 남동생하고 동네 편의점에 가서 맛있는 사탕이나 소다 사고 먹었으면 참 기뻤다.
그렇지만 사춘기 되면 행복하게 만드는 것이 좀 바뀐다.	그렇지만 사춘기가 되면 행복하게 만드는 것이 좀 바쁘지지.
물론 맛있는 사탕을 먹으면 좋은데 그것이 애인과 사귀는 것만 못했다.	물론 먹으면 좋은데 그것이 애인과 사귀는 것만 못했다.
특히 고등학교와 대학교에 다니는 학생들을 보면 애인이랑 손을 잡고 학교에서 걸어다니는 커플들이 정말 행복해 보인다.	특히 고등학교와 대학교에 다니는 학생들을 보면 애인과 손을 잡고 학교에서 걸어다니는 커플들이 정말 행복해 보인다.
그래서 지금까지 행복은 무슨 뜻인지 생각을 하면 사랑에 빠지는 것인 줄 안다.	그래서 지금까지 행복은 무슨 뜻인지 생각을 하면 사랑에 빠지는 것인 줄 안다.
난 아직 30대여서 나이가 많은 분의 의견으로는 잘 이야기를 못하지만 내 생각으로는 내가 아버지가 되면 나를 행복하게 할 것은 아마 아이를 행복하고 성공한 거일 것 같다.	난 아직 30대여서 나이 많은 분 의견으로 잘 이야기를 못하지만 내가 아버지가 되면 내 행복하게 할 것은 아마 아이를 행복하게 하는 것 같다.
저는 몬타나주에서 태어나 몬타나주에서 자랐어요.	저는 몬태나주에서 태어나 몬태나주에서 자랐어요.
21년 동안 제가 매우 아름다운 산 옆에서 돌아다녔고 참 예쁜 나무와 꽃 가운데 성장했고 또 가장 크고 맑은 하늘 아래에서 놀아 왔어요.	제가 매우 아름다운 산 옆을 돌아다녔고 참 예쁜 나무가 자라고 있었고 또 가장 크고 맑은 하늘 아래에서 놀았어요.
그런 경치 속에서 살아오는 것이 별로 크지 않다고 생각했는데 이제 저는 몬타나주가 지구에서 제일 아름다운 곳 중에 하나라는 것을 알게 되었어요.	그런 경치 속에서 살아오는 것이 별로 크지 않다고 생각했는데 이제 저는 몬태나주가 지구의 제일 아름다운 곳 중 하나라는 것을 알게 되었어요.
여행을 가려면 제가 추천해 드리는 장소는 Glacier National Park예요.	여행을 가려면 제가 추천해 드리는 장소는 Glacier National Park이에요.
빙하 국립 공원은 몬타나의 북서쪽에 위치하는데 캐나다 바로 밑에 있어요.	빙하 국립공원은 몬태나의 북서쪽에 위치하는데 캐나다 바로 밑에 있어요.
울창한 숲과 넓은 목초지와 당당한 산과 수정처럼 보이는 호수 등이 있어요.	울창한 숲과 넓은 목초지와 당당한 산과 수정처럼 보이는 호수가 있어요.
그 곳은 경치가 좋기로 유명하대요.	그곳은 경치가 좋기로 유명하대요.
등산을 좋아하는 사람들이 빙하 국립 공원을 낙원으로 여겨요.	등산을 좋아하는 사람들이 빙하 국립 공원을 낙원으로 여겨요.
그 공원에 등산할 길이 700마일이 있습니다.	그 공원에 등산할 길이 700마일 있습니다.
등산하면서 자연 속에서 사는 동물과 식물을 보기가 쉬워요.	등산하면서 사는 동물과 식물을 보기 쉬워요.
동물 종류가 엄청 많고 아주 다양해요.	동물의 종류가 엄청 많고 아주 다양해요.
그 동물 중 회색곰 , 오소리 , 늑대 , 및 시라소니도 있어요.	그 동물 중 희색곰, 오소리, 늑대 및 스라소니도 있어요.
또 새 종류가 260 마리 이상 있는데 오리 , 독수리 NONE 및 물까마귀가 포함되어 있어요.	또 새 종류가 이상 있는데 오리, 독수리, 및 물까마귀가 포함되어 있어요.
" 빙하 국립 공원이라고 " 왜 부르냐 하면 그 공원의 주요 특징은 10,000 년 된 빙하 산들이예요.	국립이라고 부르는 이유는 그 공원의 주요 특징이 빙하로 이루어진 산들이기 때문이에요.
그래서 이 공원에서 볼 수 있는 경치가 지구의 유일한 빙하 경치예요.	그래서 이 공원에서 볼 수 있는 경치가 지구의 유일한 빙하 경치예요.
그런 천국과 비교될 수 있는 관광지가 돈이 많이 드나 보죠?	그런 천국과 비교될 수 있는 관광지가 돈이 많이 드나 보죠?
그렇지 않아요.	그렇지 않아요.
입장료가 10 - 20 달러밖에 안 들어요.	입장료가 밖에 없다.
가족과 같이 가려면 너무 편리하고 싼 가족 판매도 있어요.	가족과 같이 가려면 너무 편리하고 저렴한 가족 할인도 있어요.
저는 어렸을 때 가장 즐거운 추억 가운데 이 공원에 가는 건 하나예요.	저는 어렸을 때 가장 즐거운 이 공원에 가는 건 하나예요.
구경하는 동안 제 가족이 많은 행복한 기억을 만들었고 우리 자연에 대해 신경이 많이 커졌으며 우리는 의미있는 시간을 보냈나 봐요.	구경하는 동안 제 가족이 많은 행복한 기억을 만들었고 우리 자연에 대해 신경이 많이 커졌으며 우리는 의미 있는 시간을 보냈나 봐요.
여러분들이 빙하 국립 공원에 가면 같은 추억과 즐거움을 경험할 수 있겠네요.	여러분이 빙하 국립 공원에 가면 같은 추억과 즐거움을 경험할 수 있겠네요.
가족 관계도 강화될 것이라고 생각하기도 그래요.	가족 관계도 강화될 것이라고 생각하기도 해요.
빨리 전화해서 예약하세요!	빨리 전화해서 예약하세요!
다른 여행보다 더 할만한 여행이 없어요!	다른 여행보다 더 할 만한 여행이 없어요!
!	위의 글을 읽고 맞춤법 오류를 수정한 글만 출력해 줘.
저는 여행을 많이 안 했지만 제가 가는 데는 참 좋았습니다.	저는 여행 많이 가는 데는 참 좋았습니다.
제가 제일 좋아하는 데는 역시 대한민국입니다.	제가 제일 좋아하는 곳은 역시 대한민국입니다.
대한민국에서 제가 강원도 , 서울시 , 의정부와 일산 / 원당에 가 봤습니다.	대한민국에 제가 강원도, 서울시, 의정부에 갔습니다.
의정부 지역은 제가 제일 좋아하는 장소입니다.	의정부 지역은 제가 제일 좋아하는 장소입니다.
의정부에 가면 정말 좋아하시겠습니다.	의정부에 가면 정말 좋아하시겠어요.
제가 의정부에 살았을 때 선교사업을 했는데 그것을 함으로써 많은 걸 봤습니다.	제가 의정부에서 많은 것을 봤습니다.
서울보다 사람이 되게 많이 없고 시골보다 편리합니다.	서울만큼 크지 않고 시골보다 편리합니다.
또 서울에 가려면 지하철로 40분만 걸리고 시골에 가려면 버스나 차로 30분만 걸립니다.	또 서울에 가려면 지하철로 40분만 걸리고 시골에 가려면 버스나 차로 30분만 걸립니다.
산들이 아주 아름답고 , 등산을 좋아하면 기회가 많이 있습니다.	산은 아주 아름답고, 등산을 좋아하면 기회가 많이 있습니다.
특별히 맛있는 음식이 정말 되게 많이 있습니다.	특별히 맛있는 음식 정말 되게 많이 있습니다.
특히 부대찌게는 아주 아주 맛이 있습니다.	특히 부대찌개는 맛이 있습니다.
사람들이 도시 사람보다 친절하고 따뜻합니다.	사람들이 친절하고 따뜻합니다.
작년 가을에 의정부에 있었습니다.	작년 가을에 의정부에 있었습니다.
날씨가 완전했습니다.	날씨가 완벽했습니다.
지금 가을이기 때문에 많이 그립습니다.	지금 가을이기 때문에 많이 그립습니다.
의정부에 가면 정말 행복하시겠고 결코 잊겠습니다!	의정부에 가면 정말 행복하겠고 결코 잊지 않겠습니다!
제가 한국 전통적인 한복과 한국의 지혜에 대해 쓰고자 합니다.	제가 한국 전통 한복과 한국의 지혜에 대해 쓰고자 합니다.
한국의 고유한 풍습 중에 한복은 아주 인상적인 추억을 남겨주는 능력이 있답니다.	한국의 고유한 풍습 중에 한복은 아주 인상적인 추억을 남겨주는 능력이 있답니다.
특히 외국 사람들 눈에는 더욱 그렇습니다.	특히 외국 사람들의 눈에는 더욱 그렇습니다.
몸의 굴곡대로 되지 않고 몸의 굴곡을 감싸는 것이 오히려 은근한 매력이 있나 봅니다.	몸의 굴곡을 그대로 두지 않고 몸의 굴곡을 감싸는 것이 오히려 은근한 매력이 있다고 봅니다.
곡선이 우아하고 야하지 않아서 맵시도 나고 분위기도 좋습니다.	곡선이 우아하고 야하지 않아서 맵시도 나고 분위기도 좋습니다.
색깔이 화려한 것보다는 은은한 색깔에다가 짙은 깃과 고름을 맸습니다.	색깔이 화려한 것보다는 은은한 색깔에 짙은 깃과 고름을 맸습니다.
아이 옷에 원색이나 동색을 썼지만요.	원색이나 동일한 색을 썼지만요.
세월이 흐르면서 한국인의 습관도 달라지고 있습니다.	세월이 흐르면서 한국인의 습관도 달라지고 있습니다.
요즘 같아선 바쁘다고 해서 한복이 양복에 밀려나는 모양입니다.	요즘 같아선 바쁘다고 해서 한복이 양복에 밀려나는 모양입니다.
사실은 손이 많이 가는데 그래도 한국의 우아스러운 모습만 하겠는가 합니다.	사실은 손이 많이 가는데 그래도 한국의 우아한 모습만 하겠는가 합니다.
우리 성격에 미치는 영향은 다양하다고 생각합니다.	우리 성격에 미치는 영향이 다양하다고 생각합니다.
부모님께 받은 유전적인 영향이 있지만 제일 큰 영향이 무엇이냐면 우리 환경에서 받은 영향입니다.	부모님에게 받은 유전적인 영향이 있지만 제일 큰 영향은 우리 환경에서 받은 영향입니다.
우리 성격은 우리가 쌓을 경험에 달려 있습니다.	우리 성격은 우리가 쌓을 경험에 달려 있습니다.
나쁜 경험을 많이 당한 사람들은 부정적인 생각을 많이 갖게 되고 항상 기쁜 경험을 가지고 있는 사람들은 좋은 성격을 가지는 가능성이 높습니다.	나쁜 경험을 많이 당한 사람들은 부정적인 생각을 많이 갖게 되고 항상 기쁜 경험을 하고 있는 사람들은 좋은 성격을 가질 가능성이 높습니다.
성격에 영향을 주는 환경 중에서 가족과 학교의 환경이라고 봅니다.	성격에 영향을 주는 환경 중에서 가족과 학교 환경이라고 봅니다.
특히 사춘기에 우리 성격이 어떻게 될지 정해집니다.	특히 사춘기에 우리 성격이 어떻게 될지 정해집니다.
그 때는 무슨 나쁜 일이 생기면 우리 성격이 크게 변할 수가 있습니다.	그때는 무슨 나쁜 일이 생기면 우리 성격이 크게 변할 수가 있습니다.
가족의 영향도 크다고 생각합니다.	가족의 영향도 크다고 생각합니다.
부모님께서 엄격하면 자유롭지 않은 환경은 나쁜 영향을 끼칠 경우도 있답니다.	부모님이 엄격하면 자유롭지 않은 환경이 나쁜 영향을 끼칠 경우도 있답니다.
그런데 부모님께서 자기 자식을 너무 자유롭게 살게 하면 성격 형성에 좋은 영향을 주지 않는 것 같습니다.	그런데 부모님이 너무 자유롭게 살게 하면 좋은 영향을 주지 않는 것 같습니다.
그리고 우리는 자랄 때뿐만 아니라 어른 시절에도 성격 변화가 생길 수가 있습니다.	그리고 우리는 자랄 때뿐만 아니라 어른 시절에도 성격 차이가 있습니다.
충격적인 사건은 우리 성격을 바꿉니다.	충격적인 사건은 우리 성격을 바꿉니다.
예를 들어서 기다하지 않은 사별은 적극적인 성격을 부정적인 성격으로 바꿀 수 있습니다.	예를 들어서 기대하지 않은 사별은 적극적인 성격을 부정적인 성격으로 바꿀 수 있습니다.
물론 대부분의 경우에는 나쁜 경험이 우리 성격에 직접적인 효과를 보이지 않습니다.	물론 대부분의 경우에는 나쁜 경험이 우리 성격에 직접적인 효과를 보이지 않습니다.
무엇보다도 다양한 성격이 존재하는 사실이 아주 좋다고 봅니다.	무엇보다도 다양한 성격이 존재한다는 사실이 아주 좋다고 봅니다.
모든 사람들이 똑같은 성격을 가지고 있는 세상을 상상해 보세요.	모든 사람들이 똑같은 성격을 가지고 있는 세상을 상상해 보세요.
얼마나 우울할까요?	얼마나 우울할까요?
한국으로 여행하실 계획이 있으십니까?	한국에 여행할 계획이 있으십니까?
잘 선택하셨습니다.	잘 선택하셨습니다.
왜냐하면 거기에 볼 만한 게 많기 때문이에요.	왜냐하면 거기에 많기 때문이에요.
저는 한 방문할 만한 곳을 소개해 드릴게요.	저는 한 곳을 방문할 것을 소개해 드릴게요.
.	위의 글을 읽고 맞춤법 오류를 수정한 글만 출력해 줘.
.	위의 글을 읽고 맞춤법 오류를 수정한 글만 출력해 줘.
인천에 있는 수도국산 박물관입니다.	인천에 있는 수도산 박물관입니다.
거기서는 옛날에 ( 30 - 40 년 전 ) 보통 한국 사람들이 어떻게 생활했는지가 전시가 됩니다.	거기서는 옛날 보통 한국 사람들이 어떻게 생활했는지를 전시합니다.
저는 올해 여름에 갔다왔습니다.	저는 올해 여름에 갔다 왔습니다.
그 때 선교사로 인천에서 봉사하고 있었습니다.	선교사로 인천에서 봉사하고 있었습니다.
아주 매력적인 도시입니다.	아주 매력적인 도시입니다.
인천항까지 가기 전에 동구 언덕 위에 이 박물관이 있습니다.	인천항까지 동구에 이 박물관이 있습니다.
입금이 500원입니다.	입금액이 500원입니다.
그래서 가족을 데려가도 비싸지 않습니다.	그래서 가족을 데려가도 비싸지 않습니다.
수도국산 박물관에 들어가면 어두워요.	수도산 박물관에 들어가면 어두워요.
길거리에 다 걸어갈 수 있는 등 시대의 전사하기 인공으로 만든 도시입니다.	길거리가 전부 인공으로 만든 도시입니다.
수백 많은 실물 크기의 인형이 있기도 합니다.	인형이 있기도 합니다.
수도산은 옛날부터 한강에서 퍼서 사람들이 마시기 위해 보내는 장소입니다.	수도산은 옛날부터 한강에서 벗어나 사람들이 모이는 장소입니다.
그 물을 가지고 팔았습니다.	가져다 팔았습니다.
그리고 이 박물관에 가면 이 도시에서 살던 사람들이 어떻게 살았는지 알 수 있습니다.	그리고 이 박물관에 가면 살던 사람들이 어떻게 살았는지를 알 수 있습니다.
가난한 집들이 있습니다.	간단한 집들이 있습니다.
집 밑에 온돌기가 보입니다.	온도계를 보입니다.
그리고 물 파는 장소와 물장수의 물지게가 있어서 들어 볼 수 있게 합니다.	그리고 물 파는 장소와 물장수의 물지게가 있어서 들어볼 수 있게 합니다.
( 하지만 물이 없어서 들기 쉬워요 ).	물이 없어서 들키.
열 집이 NONE 공동으로 쓰는 푸세식이 있고 휴지가 없어서 사람들이 신문을 쓴다고 합니다.	열 집이 한 공통으로 쓰는 부엌이 있고 휴지가 없어서 사람들이 신문을 쓴다고 합니다.
또한 아이들이 학교에 못 가서 일을 마친 다음에 밤에 대학생한테서 교육을 무료로 받을 수 있었는 공부방이 있읍니다.	또한 아이들이 학교 일을 마친 다음에 밤에 대학생한테서 교육을 무료로 받을 수 있는 공부방이 있습니다.
길거리에 다니는 개와 지붕으로 다니는 고양이도 있습니다.	길거리 다니는 개와 지붕을 다니는 고양이도 있습니다.
재미있습니다.	재미있습니다.
이상한 게 뭐냐 하면 오래된 인천에 사람이 이런 곳에서 사는 것을 지금까지 볼 수 있습니다.	이상한 게 뭐냐 하면 오래된 인천에 사람이 이런 곳에서 사는 것을 지금까지 볼 수 있습니다.
하지만 수도산 박물관에 가면 30 - 40년 전에 한국 사람들이 얼마나 고통받고 그 안에 나라가 얼마나 발전했는지 감사해집니다.	하지만 수도산 박물관에 가면 전에 한국 사람들이 얼마나 고통받았고 나라가 얼마나 발전했는지 감사하게 됩니다.
한국 사람의 수고함과 겸손함에 대한 존경을 가져 떠납니다.	한국 사람의 수고와 겸손함에 대한 존경을 가지고 떠납니다.
누구든지 좋은 경험이 될 것입니다.	누구에게나 좋은 경험이 될 것입니다.
잘 가!	잘 가!
어느 사람이 행복과 불행 사이에 2%의 차이가 나와 있다고 말씀했습니다.	어느 사람이 행복과 불행 사이에 2%의 차이가 있다고 말씀했습니다.
그리고 누구든지 행복하고 싶다면 그냥 " 나는 행복한다 " 고 생각만 하면 그 2%의 “ 행복 " 쪽으로 기울 수 있다고 했습니다.	그리고 누구든지 행복하고 싶다면 그냥 그 2%의 기울이라고 했습니다.
인간이 행복하게 사는 이유들이 여러 가지 있습니다.	인간이 행복하게 사는 이유들이 여러 가지 있습니다.
사람들이 다른 사람들 때문에 행복할 수도 있습니다.	사람들이 다른 사람들 때문에 행복할 수도 있습니다.
가족이나 친구나 이웃이 있어서 행복할 수도 있고 불행할 수도 있죠.	가족이나 친구나 이웃이 있어서 행복할 수도 있고 불행할 수도 있죠.
인간이 불행이나 슬픔을 느끼는 이유도 행복과 마찬가지로 여러 가지가 있습니다.	인간이 불행이나 슬픔을 느끼는 이유도 행복만큼이나 있습니다.
실패 , 실망 , 실수 , 싸움과 사망 때문에 불행할 수 있습니다.	실패, 실망, 실수, 싸움과 사망 때문에 불행할 수 있습니다.
그러나 누군가 혁신적인 생활을 할 수 있다면 안 좋은 일들이 있어도 행복을 찾을 수 있습니다.	그러나 누군가 혁신적인 생활을 통해 행복을.
물론 , 우리 모두 다 불행 시간이나 슬픈 시간이나 우울한 시간이 있겠습니다.	물론, 우리 모두 다 불행한 시간이나 우울한 시간이 있겠습니다.
여러분이 무슨 일이 있어도 맨날 항상 행복한 사람을 알고 있으면 조심하십시오.	여러분에게 무슨 일이 있어도 항상 행복한 사람이 알고 있으면 조심하십시오.
그 사람이 이상할 수도 있습니다.	그 사람이 있습니다.
불행과 슬픔 가운데 혁신적인 생각과 행동을 함으로써 좀더 행복한 생활들을 인도할 수 있으면 좋겠습니다.	불행과 슬픔 가운데 혁신적인 생각과 행동함으로써 좀 더 행복한 생활들을 좋겠습니다.
제가 방문한 곳들 중에 한 아주 좋아하는 곳이 있습니다.	제가 방문한 한 아주 좋아하는 곳이 있습니다.
저는 어렸을 때부터 옐로스톤 국립 공원을 특별히 좋아했습니다.	저는 옐로스톤 국립공원을 특별히 좋아했습니다.
저의 어머니도 이 공원을 아주 좋아해서 제 가족이 그 곳에서 여행을 많이 했습니다.	저의 어머니도 이 공원을 아주 좋아해서 제 가족이 그곳에 여행을 많이 갔습니다.
지금까지 저는 제 가족과 함께 옐로스톤 국립 공원을 거의 열다섯 번 방문했을 것입니다.	지금까지 저는 제 가족과 함께 옐로스톤 국립공원에 거의 열다섯 번 방문했을 것입니다.
하지만 요즈음에 제가 한국에서 선교사업을 하고 지금 대학교에 다니느라고 옐로스톤에 가지 못했습니다.	하지만 요즘에 제가 한국에서 선교 사업하고 지금 대학교 다니느라 옐로스톤에.
제가 방문한 지 아마 사 년쯤 되었을 것입니다.	저는 아마 사 년쯤 되었을 것입니다.
옐로스톤에서 할 것이 많습니다.	옐로스톤에서 할 것이 많습니다.
자연에서 사는 동물들이 많아서 재미있습니다.	자연에서 사는 동물들이 많아서 재미있습니다.
물소 , 사슴 , 곰 , 늑대와 무스 다 볼 수 있습니다.	물소, 사슴, 곰, 늑대와 무스를 다 볼 수 있습니다.
하지만 늑대들이 아주 드물어서 제가 열심히 찾아 봤어도 못 봤습니다.	하지만 늑대들이 아주 드물어서 저는 열심히 찾아봤지만 못 봤습니다.
동물 찾는 것 외에도 많은 재미있는 것을 경험할 수 있습니다.	동물을 찾는 많은 재미있는 것을 경험할 수 있습니다.
등산을 좋아하는 사람들이 옐로스톤을 특별히 좋아할 것입니다.	등산을 좋아하는 사람들이 옐로스톤을 특별히 좋아할 것입니다.
이 공원의 경치가 세상에서 최고입니다.	이 공원의 경치가 세상에서 최고입니다.
이 많은 이유하고 저는 이 곳을 굉장히 좋아하기 때문에 옐로스톤 국립 공원을 모든 사람들한테 추천 드립니다.	이 많은 이유로 저는 이곳을 굉장히 좋아하기 때문에 옐로스톤 국립공원을 모든 사람들에게 추천드립니다.
당신이 행복하게 살기 위해서는 정확하게 상황을 판단하는 것이 중요해요.	당신이 행복하게 살기 위해서는 정확하게 상황을 판단하는 것이 중요해요.
어떤 사람들은 행복하게 살기 위해서 행복이나 만족을 찾아야 한다고 해요.	어떤 사람들은 행복하게 살기 위해서 행복이나 만족을 추구해요.
하지만 이건 잘못된 생각이에요.	하지만 이런 잘못된 생각이에요.
실제로 불가능해요.	실제로 불가능해요.
당신이 최대한 할 수 있는 만큼 모든 상황에서 이익을 얻으려고 노력해야 돼요.	당신이 최대한 할 수 있는 만큼 모든 상황에서 이익을 얻으려고 노력해야 돼요.
이 때 너무 감정에 치우치지 않도록 주의해야 해요.	너무 감정적이다.
감정에 지나치게 치우치게 된다면 결국 비이성적인 결정을 하게 돼요.	감정에 지나치게 치우치게 된다면 결국 비이성적인 결정을 하게 돼요.
이에 인생은 포커 게임과 비슷하다고 할 수 있어요.	이런 인생은 포커 게임과 비슷하다고 할 수 있어요.
포커 게임에서 당신의 감정을 조절하고 당신으로부터 다른 사람이 이익을 얻게 못하게 하는 것이예요.	포커 게임에서 당신의 감정을 조절하고 당신으로부터 다른 사람이 이익을 얻게 못하게 하는 것이에요.
조절하는 동안 당신은 적의 약점을 분석해야 해요.	당신은 적의 약점을 분석해야 해요.
당신보다 상대방이 낫다고 생각되면 그 순간을 잡아야 해요.	당신보다 상대방이 낫다고 생각되면 그 순간을.
또 만약 당신보다 다른 사람들이 잘하면 포기할 순간이 왔다는 것을 알아차려야 해요.	또 만약 당신보다 다른 사람들이 잘하면 포기할 순간이 왔다는 것을.
때때로 당신이 행운을 얻을 수 있어요.	때때로 당신에게 행운이.
다른 때에는 다른 사람이 그 행운을 얻을 수도 있어요.	다른 사람이 그 행운을 얻을 수도 있어요.
그러나 당신은 당신의 실수로부터 무언가를 배운다면 당신이 더 나아질 수 있어요.	그러나 당신이 당신의 실수로부터 무언가를 배운다면 당신이 더 나아질 수 있어요.
그 행운이 필요없게 되는 것이에요.	그 행운이 필요 없게 되는 것이에요.
당신은 어려운 상황을 철저한 분석으로 극복하는 것을 배우고 나면 삶을 더욱 편하고 행복하게 살 수 있어요.	당신은 어려운 상황을 철저한 분석으로 극복하는 것을 배우고 나면 삶이 더욱 편하고 행복해진다.
남은 여생 동안 그 동안 지녀온 현명한 선택과 함께 행복하게 살 수 있게 되는 것이예요.	남은 지녀온 행복하게 되는 것이에요.
제가 갔다온 곳은 뉴욕시입니다.	저의 뉴욕시입니다.
저는 4번 가 봤습니다.	제가 4번.
뉴욕은 너무 큰 도시입니다.	뉴욕은 너무 큰 도시입니다.
구경할 수 있는 곳들이 많고 멋이 있습니다.	구경할 수 있는 곳들이 많고 멋이 있습니다.
추천한 곳들은 Broadway , Statue of Liberty , 그리고 Empire State Building입니다.	추천한 곳들은 Broadway, Statue of Liberty, 그리고 Empire State Building입니다.
Broadway는 뉴욕의 Manhattan섬에 있고 극장과 같은 데가 많습니다.	Broadway는 뉴욕의 Manhattan섬에 있고 극장과 같은 곳이 많습니다.
세상에서 제일 유명하고 큰 연극과 뮤지컬들이 Broadway에 있는 극장들에서 역을 합니다.	세상에서 제일 유명하고 큰 연극과 뮤지컬들이 Broadway에 있는 극장들에서 공연을 합니다.
뉴욕에 갈 때Z 꼭 Broadway에서 몇 가지 연극이나 뮤지컬을 봐야 됩니다.	뉴욕에 곧 Broadway에서 몇 가지 연극이나 뮤지컬을 볼 예정이다.
Statue of Liberty는 ( 자유의 여신상 ) 뉴욕 옆에 있는 Hudson강 가운데 있습니다.	Statue of Liberty (자유의 여신상)은 뉴욕 옆에 있는 Hudson 강 가운데에 있습니다.
그 상은 아주 높고 아름답고 미국에서 매우 유명한 것입니다.	아주 높고 아름다우며 미국에서 매우 유명한 것입니다.
구경하고 싶은 사람들이 그 상에 들어갈 수 있고 꼭대기까지 갈 수 있고 그 높은 데에서 뉴욕 도시+를 다 볼 수 있습니다.	구경하고 싶은 사람들이 돌아갈 수 있고 꼭대기까지 갈 수 있는 곳에서 뉴욕 도시를 다 볼 수 있다.
가신다면 잊지 않을 거예요.	가신다면 잊지 않을게요.
또 다른 높은 것은 Empire State 빌딩입니다.	또 다른 높은 것은 엠파이어 스테이트 빌딩입니다.
지금은 뉴욕에서 제일 높은 것입니다.	지금은 뉴욕에서 제일 높은 건물입니다.
63 빌딩처럼 그 빌딩의 지붕에 갈 수 있고 뉴욕 도시를 볼 수 있습니다.	63빌딩처럼 지붕에서 뉴욕 도시를 본다.
저는 이 모든 곳에 갔다왔는데 너무 좋아해서 추천하고 싶습니다.	저는 그곳에 갔다 왔는데 너무 좋아서 추천하고 싶습니다.
저는 8년 동안 육군 생활을 하면서 건강 관리가 습관이 됐습니다.	저는 8년 동안 하면서 습관이 되었습니다.
물론 , 군대에서 운동을 맨날 맨날 했는데 지금도 일주에 최소한 3 - 4번 운동을 하지 않으면 기분이 안 좋고 피곤하게 돼요.	물론, 군대에서 운동을 맨날 맨날 했는데 지금도 일주일에 최소한 운동을 하지 않으면 기분이 피곤하게 돼요.
요즈음에는 운동하기에 특별한 방법은 없어요.	요즘에는 운동하기에 특별한 방법은 없어요.
체육관에 가서 그 순간에 마음에 드는 운동을 합니다.	체육관에 가서 그 순간에 마음에 드는 운동을 합니다.
제가 제일 좋아하고 잘하는 운동은 수영입니다.	제가 제일 좋아하고 잘하는 운동은 수영입니다.
빠른 속도로 수영하는 것보다 장거리 수영을 많이 즐겨요.	빠른 속도로 수영하는 것보다 장거리 수영을 더 많이 즐겨요.
수영할 때 , 저는 원래 최소한 1킬로미터나 합니다.	수영할 때, 저는 원래 최소한 1킬로미터나 합니다.
언제나 시간이 될 때 , 4 - 5 킬로 수영도 합니다.	언제나 시간이 될 때 수영도 합니다.
제가 제일 먼 거리를 수영한 적이 언제냐면 고등학교 때 “수영마라톤”에 참가했어요.	제가 제일 처음 “수영마라톤”에 참가했어요.
그 경기의 거리가 20킬로였으며 5시간 걸렸어요.	그 경기의 거리가 20킬로였으며 5시간 걸렸어요.
그 때는 제가 1킬로를 15분 정도에 수영할 수 있었어요.	제가 1킬로가 있었어요.
그러나 그 경기에 참가한 지 16년이 다 됐어요.	그러나 그 경기가 열린 지 16년이 다 됐어요.
세월이 쏜쌀같지요?	세월이 쏜살같지요?
한국에 처음 가 보실 계획을 갖고 계십니까?	한국에 처음 계획을 잡고 계십니까?
그렇다면 저는 한국에 조금 있었기 때문에 언제 그리고 어다로 가 보시면 좋은지를 설명 드리겠습니다.	그렇다면 저는 한국에 조금 있었기 때문에 언제 어디로 좋은지를 설명 드리겠습니다.
먼저 한국에는 가을에 꼭 가셔야 합니다.	먼저 한국 가을에는 곡.
왜냐하면 한국에 아주 멋진 나무들과 산들이 있는데 가을에 나무의 잎들이 색깔이 변하기 시작하기 때문입니다.	왜냐하면 한국에 아주 멋진 나무들과 가을에 나무의 잎들이 색깔이 변하기 시작하기 때문입니다.
그리고 그 기간에 제일 멋있는 데는 바로 설악산입니다.	그리고 그 기간에 제 바로 설악산에 갔습니다.
한국의 제일 높은 산들 중에 하나이고 아주 좋은 갈 만한 곳입니다.	한국에서 제일 높은 산들 중 하나이고 아주 좋은 곳입니다.
저는 2007년 10월에 가 보았습니다.	저는 위의 글을 읽고 맞춤법 오류를 수정한 글만 출력해줘.
그 때는 너무 많이 좋았구요 아마 제일 좋았던 거는 산에 올라가는 케이블 카를 타 보았고 탄 다음에 속초 한 도시를 다 볼 수 있었고 바다가 더 아주 잘 보였습니다.	너무 많이 좋았고요 아마 제일 좋았던 것은 산에 올라가는 케이블카를 탄 다음에 속초 한 도시가 다 바다가 더 아주 잘 보였습니다.
그래서 다시 말해서 설악산에 꼭 가 보십시오.	그래서 다시 말해서 설악산에 곡.
제가 LA에 있을 때 가끔 롱 비치로 갔습니다.	제가 LA에 있을 때 가끔 롱비치로 갔습니다.
롱 비치는 제 집에서 멀지 않고 차를 타고 가면 40 분 정도만 걸립니다.	롱 비치는 제 집에서 멀지 않아 가면 걸립니다.
저기서 큰 해변이 있고 그리고 할 수 있는 여러 가지 재미있는 것들이 있습니다.	저기 큰 해변이 있고 할 수 있는 재미있는 것들이 있습니다.
예를 들면 다른 데서 맛볼 수 없는 음식이 많고 그리고 동양적인 식당하고 노래방도 있습니다.	예를 들면 맛볼 수 없는 음식이 많고 또한 동양적인 식당과 노래방도 있습니다.
심심하거나 그냥 돈이 없으면 롱 비치에서 많이 놀 수 있습니다.	심심하거나 그냥 돈이 없으면 롱 비치에서 많이 놀아.
돈이 없으면 해변을 방문해 보십시오.	돈이 없으면 해변에.
아침 , 낮 , 밤에 가면 아릅답습니다.	낮, 밤에 가면 아름답습니다.
그리고 여자친구나 남자친구랑 가면 아주 특별한 데이트가 될 수 있답니다.	그리고 여자친구나 남자친구와 가면 아주 특별한 데이트가 될 수 있답니다.
( 저는 모르겠지만 ^^ ) 아무튼 추천합니다.	저는 모르겠지만 ^^ 아무튼 추천합니다.
한번 꼭 가 보십시오.	한 번 꼭.
내가 좋아하는 것과 잘하는 것을 감안하면 변호사가 되는 게 별로 안 좋은 것 같아요.	내가 좋아하는 것과 잘하는 것을 감안하면 변호사가 되는 게 별로 안 좋은 것 같아요.
다른 것을 공부했더라면 좋았을 걸.	다른 것을 공부했더라면 좋았을걸.
마음 같아선 내가 지망하는 일을 할 수 있다면 얼마나 좋을까요?	마음 같아서는 내가 지망하는 일을 할 수 있다면 얼마나 좋을까요?
그런데 벌써 2년 동안 대학원을 다녀서 졸업하고 취직해야 돼요.	그런데 벌써 2년 동안 대학원을 다녔으니 졸업하고 취직해야 돼요.
미국에서는 학비가 비싸니까 학생들이 대출을 많이 해서 자기 관심과 거리가 멀어도 돈을 많이 버는 직업을 선택하는 사람이 여간 많지 않아요.	미국에서 학비가 비싸니까 학생들이 대출을 많이 해서 자기 관심과 거리가 멀어도 돈을 많이 버는 직업을 선택하는 사람이 여간 많지 않아요.
하지만 쥐구멍에도 볕들 날이 있어요.	하지만 쥐구멍에도 볕 들 날이 있어요.
앞으로 빚을 갚으면 나는 신문기자가 되고 싶어요.	앞으로 빚을 갚고 내가 신문 기자가 되고 싶어요.
날마다 새로운 사건들이 생기니까 신문사에서 일하는 게 재미있을 것 같아요.	날마다 새로운 사건이 생기니까 신문사에서 일하는 게 재미있을 것 같아요.
변호사들은 보통 하루종일 책상 앞에 앉지만 신문 기자들은 밖에 나가고 여러 사람을 만날 수 있어요.	변호사들이 보통 하루 종일 책상 앞에 앉아 있지만 밖에 나가서 만날 수 있어요.
내가 워낙 변덕스러워서 신문 기자같은 불규칙적인 생활을 좋아해요.	내가 워낙 변덕스러워서 신문 기자 같은 불규칙적인 생활을 좋아해요.
더군다나 외국에서 일하거나 공부하는 걸 좋아해서 특파원이 되는 게 좋을 것 같아요.	더군다나 외국에서 일하거나 공부하는 걸 좋아해서 특파원이 되는 게 좋을 것 같아요.
과연 내가 신문 기자가 될 수 있을까요?	과연 내가 될 수 있을까요?
모든 사람들이 완래 성격이 다른데 환경 때문에 성격이 더 달라져요.	모든 사람이 원래 성격이 다른데 환경 때문에 성격이 더 달라져요.
성격이 좋은 아이가 태어날 때 환경이 나쁘다면 아이가 좀더 나빠지고 반대로 환경이 좋다면 아이가 괜찮을 것 같아요.	성격 좋은 아이 태어날 때 환경이 나쁘다면 아이가 좀 더 나빠지고 반대로 환경이 좋다면 아이가 괜찮을 것 같아요.
윗물이 맑아야 아랫물이 맑다는 말은 부모님이나 선생님한테 바른 행동과 바른 말로 배우는 것을 말해요.	윗물 맑아야 아랫물 맑다는 말은 부모님이나 선생님한테 바른 행동과 바른 말로 배우는 것을 말해요.
돈이 얼만큼 있는지 특히 중요하지 않고 친구와 가족한테서 사랑을 받아야 돼요.	돈이 얼마만큼 있는지 특히 중요하지 않고 친구와 가족에게서 사랑을 받아야 돼요.
그 말은 돈이 있다고 해도 사랑을 못 받다면 무슨 소용이 있겠어요?	그 말은 돈이 있다고 해도 사랑이 없으면 소용이 있겠어요?
그건 그렇고 부모님이 아이한테 넓은 마음을 보여 줘야 돼요.	그건 그렇고 부모님이 아이에게 넓은 마음을 보여 줘야 돼요.
그 이유는 왜냐하면 아이가 다른 문화와 다른 사람들을 이해하도록 보여 주는 것이에요.	그 이유는 아이가 다른 문화와 다른 사람들을 이해하도록 보여 주는 것이에요.
아이가 폭력적인 환경에서 살다가는 나중에 아이한테 심각한 나쁜 영향이 있을 거예요.	아이가 폭력적인 환경에서 살다가는 나중에 아이에게 심각한 나쁜 영향이 있을 거예요.
아이가 그런 환경 외에 다른 생활이 있는지 모르겠거든 혹시 누구든지 아이를 낳을 수 있으니까 될 수 있는 대로 그 아이를 위해서 좋은 환경을 만드세요.	아이가 그런 환경 외에 다른 생활이 있는지 모르겠지만 혹시 누구든지 아이를 낳을 수 있으니까 될 수 있는 대로 그 아이를 위해서 좋은 환경을 만드세요.
떡볶이는 맵고 칼칼합니다.	떡볶이는 맵고 칼칼합니다.
떡볶이는 뜨거울 때 제일 맛있습니다.	떡볶이는 뜨거울 때 제일 맛있습니다.
떡볶이를 많이 먹으면 목이 말라서 포장마차에서 오뎅 국물을 마십니다.	떡볶이를 포장마차에서 오뎅 국물을 마십니다.
떡볶이를 만들 때 물을 끓이세요.	떡볶이 만들 때 물을 끓이세요.
끓는 동안 배추를 자르고 당근을 자르고 파를 자르세요.	끄르는 동안 배추를 자르고 당근을 자르고 파를 자르세요.
물이 끓은 다음에 떡을 넣으세요.	물을 끊은 다음에 떡을 넣으세요.
삼분 동안 끓이세요.	끄세요.
다음에 냄비에 고추장하고 설탕하고 자른 생강하고 간장하고 고춧가루하고 참기름을 높은 온도에서 저으세요.	다음에 냄비에 고추장하고 설탕하고 잘린 생강하고 간장하고 고춧가루하고 참기름을 넣고 온도에 저으세요.
잘은 야채도 냄비에 넣어서 볶으세요.	잘은 야채도 냄비에 넣어서 볶으세요.
오뎅도 냄비에 넣어서 볶으세요.	어댕도 냄비에 넣어서 볶으세요.
냄비에 국물을 넣으세요.	냄비에 국물을 넣으세요.
그 다음에 끄린 떡을 냄비에 넣어서 볶으세요.	그다음에 끓인 떡을 냄비에 넣어서 볶으세요.
냄비의 성분을 다 볶은 다음에 드세요.	냄비에 재료를 다 볶은 다음에 드세요.
국물을 적지 않게 만들면 더 맛있어요.	국물을 만들면 더 맛있어요.
저는 웰슬리 대학교를 다닙니다.	저는 웰즐리 대학교를 다닙니다.
이번 학기에 공부를 많이 하려고 해요.	이번 학기에 공부를 많이 하려고 해요.
그리고 몸에 좋은 음식을 먹어야 돼요.	그리고 몸에 좋은 음식을 먹어야 돼요.
왜냐하면 지난 학기에는 몸에 나쁜 음식을 먹어서 자주 아팠어요.	왜냐하면 지난 학기에는 몸에 나쁜 음식을 먹어서 자주 아팠어요.
그리고 친구하고 가끔 영화를 보고 같이 놀아야 해요 물론 공부는 중요해요.	그리고 친구하고 가끔 영화를 보고 같이 놀아야 해요. 물론 공부는 중요해요.
그렇지만 쉬는 시간도 중요합니다!	그렇지만 쉬는 시간도 중요합니다!
그래서 책도 더 읽어야 돼요.	그래서 책도 더 읽어야 해요.
저는 웰슬리에 오기 전에 책벌레였어요.	저는 웰슬리에 오기 전에 책벌레였어요.
책이 너무 보고 싶어요!	책이 너무 보고 싶어요!
다음 학기에 좋은 기숙사에 살아야 해요.	다음 학기에는 좋은 기숙사에서 살아야 해요.
저는 지금 섀이퍼에 살아요.	저는 지금 셰이퍼에 살아요.
섀이퍼는 더럽고 방이 모두 작습니다.	쉐이퍼는 더럽고 방이 모두 작습니다.
다음 학기에 잠도 더 자야 돼요.	다음 학기에는 잠도 더 자야 돼요.
지난 학기에 매일 피곤했습니다.	지난 학기에 매일 피곤했습니다.
잠이 너무 부족했어요.	잠이 너무 부족했어요.
이 약속을 지키면 행복할까요?	이 약속을 지키면 행복할까요?
미국에서는 음식을 먹을 때 입을 벌리고 먹으면 안 돼요.	미국에서는 음식을 입을 벌리고 먹으면 안 돼요.
그리고 국을 먹을 때 , 소리를 크게 내면 안 돼요.	그리고 국을, 소리를 크게 내면 안 돼요.
미국에서는 포크하고 칼을 양손으로 같이 들고 먹어도 있습니다.	미국에서는 포크와 칼을 오른손으로 같이 들고 먹기도 합니다.
한국에서도 밥그릇을 들고 먹으면 안 되는 것 같이 미국에서도 스프 접시를 기울이면 안 됩니다.	한국에서도 밥그릇을 들고 먹으면 안 되는 것 같이 미국에서도 수프 접시를 기울이면 안 됩니다.
한국에서는 음식을 사람들과 같이 먹을 수 있지만 미국에서는 음식을 덜어 먹습니다.	한국에서는 음식을 사람들과 같이 먹을 수 있지만 미국에서는 음식을 덜어 먹습니다.
하지만 미국에서도 일어나고 싶을 때 한국에서와 같이 양해를 구한 후에 자리에서 일어납니다.	하지만 미국에서도 일어나고 싶을 때 한국에서처럼 양해를 구한 후에 자리에서 일어납니다.
미국의 예절은 한국의 예절과 다르지만 어떤 것은 똑같습니다.	미국의 예절은 한국의 예절과 다르지만 어떤 것은 똑같습니다.
나는 미국에서 온 김유미입니다.	나는 미국에서 온 김유미입니다.
나는 1981 년도 12월 29일에 태어났습니다.	나는 1981년 12월 29일에 태어났습니다.
태어날 때부터 나는 Bayside , Queens , NY에서 살았습니다.	저는 Bayside, Queens, NY에서 살았습니다.
오빠가 두 명입니다.	오빠입니다.
이름은 김영철이랑 김민국입니다.	이름은 김영철과 김민국입니다.
지금은 컴퓨터 회사에서 일하고 있읍니다.	지금은 컴퓨터 회사에서 일하고 있습니다.
나의 사랑스러운 부모님은 김동식이랑 이나영입니다.	나의 사랑스러운 부모님은 김동식과 이나영입니다.
우리 부모님은 사업을 하고 계십니다.	우리 부모님은 사업을 갖고 있습니다.
훌륭한 부모님이시고 많이 존경합니다.	훌륭한 부모님이시고 많이 존경을 합니다.
나는 지금 대학교 일학년으로 올라갑니다.	나는 지금 대학교 1학년으로 올라갑니다.
나도 오빠들처럼 컴퓨터 회사를 차리고 싶고 부모님처럼 훌룡한 사람이 되고 싶다.	나도 오빠들처럼 컴퓨터 회사를 차리고 싶고 부모님처럼 훌륭한 사람이 되고 싶다.
나는 그림 그리는 걸 참 좋아하고 노래 부르는 것도 잘합니다.	나는 그림 그리는 것을 좋아하고 노래 부르는 것도 잘합니다.
한국에 와서 쇼핑이 재일 재미있고 자주 백화점에 갑니다.	한국에 와서 쇼핑이 제일 재미있고 자주 백화점에 갑니다.
제 고모랑 쇼핑하는 게 제일 재미있습니다.	내 고모랑 제일 재미있습니다.
왜냐하면 값을 잘 깍습니다.	왜냐하면 값을 잘 깎습니다.
연세대학교에서 한국말을 많이 배우고 싶고 여러 사람을 만나고 싶어요.	연세대학교에서 한국말을 많이 배우고 싶고 여러 사람을 만나고 싶어요.
나는 Korean American으로서 ( 교포 ) 한국말을 잘하고 한국의 문화를 내 인생에서 살리고 싶습니다.	나는 Korean American으로서 한국말을 잘 하고 한국의 문화를 내 인생에서 살리고 싶습니다.
저는 쇼핑을 너무 좋아해요!	저는 쇼핑을 너무 좋아해요!
돈이 없어도 백화점이나 다른 옷가게가 많이 있는 곳에서 윈도우 쇼핑을 합니다.	돈이 없어도 백화점이나 다른 옷가게에서 윈도우 쇼핑을 합니다.
저는 전자제품과 신발과 다른 액세서리보다 옷을 사는 것이 제일 좋아요.	저는 전자제품과 신발과 다른 액세서리보다 옷을 사는 것이 제일 좋아요.
돈이 무척 있어서 제가 사고 싶은 것을 살 수 있으면 좋겠어요.	돈이 제가 가진 것 중에서 좋겠어요.
저는 한달마다 쇼핑을 해야 해요.	저는 한 달마다 쇼핑을 합니다.
하지만 공부와 학교 생활을 하니까 주로 온라인 쇼핑을 합니다.	하지만 공부와 학생 생활을 하다 보니 주로 온라인 쇼핑을 합니다.
도시에서의 쇼핑보다 재미가 없기는 하지만 온라인 쇼핑은 us보다 빠릅니다.	도시에서 쇼핑보다 재미는 없지만, 온라인 쇼핑은 쉽고 빠릅니다.
저번 주에 urbanoutfitters.com에서 잠바를 샀습니다.	urbanoutfitters.com에서 잠바를 샀습니다.
처음 값은 $95이었는데 세일 때문에 $78에 샀습니다.	$95이었는데 세일 때문에 $78으로 샀습니다.
온라인 쇼핑은 옷을 먼저 입어보지 못해서 위험하지만 잘 보고 사면 괜찮아요.	온라인 쇼핑은 옷을 먼저 입어보지 못해서 위험하지만 잘 보고 사면 괜찮아요.
저는 새로운 잔바를 시간을 많이 뺏기지 않고 구해서 기뻐요.	저는 새로운 장비를 시간을 많이 뺏기지 않고 구해서 기뻐요.
지난 금요일에 친구하고 파티에 갔어요.	지난 금요일에 친구랑 파티에 갔어요.
파티는 보스톤에서 있었어요.	파티는 보스턴에 있었어요.
거기에서 춤도 추고 사진도 많이 찍었어요.	위의 글은 맞춤법 오류가 없습니다.
그리고 토요일에는 나영하고 같이 스타벅스에서 심리학 책을 많이 읽었어요.	그리고 토요일에는 나영이하고 같이 스타벅스에서 심리학 책을 많이 읽었어요.
공부도 하고 구두점에 갔어요.	공부도 하고 구두방에 갔어요.
그렇지만 아무 것도 사지 않았어요.	그렇지만 사지 않았어요.
일요일에는 공부하고 피아노 연습을 했어요.	일요일에는 공부하고 피아노 연습을 했어요.
봄 연주회 준비 때문에 쇼팽 곡을 연습했어요.	봄에 연주회 준비 때문에 쇼팽 곡을 연습했어요.
지난 주말은 아주 재미있었어요.	지난 주말은 아주 재미있었어요.
이번 주말에는 아리조나에 갈 거예요.	이번 주말에는 애리조나에.
아리조나 대학에서 인터뷰할 ( 면주?	애리조나 대학에서 인터뷰
) 거예요.	위의 글을 읽고 맞춤법 오류를 수정한 글만 출력해 줘.
저는 심리학 교수가 되고 싶어요.	저는 심리학 교수입니다.
그래서 Ph.D.를 원해요.	그래서 Ph.D.를 원해요.
이번 토요일에는 돌아오고 친구하고 보스톤에서 저녁을 먹을 거에요.	이번 토요일에는 돌아오고 친구하고 보스턴에 저녁을.
맛있는 피자를 먹을 거예요.	맛있는 피자를 먹을 거예요.
그리고 극장에서 " Because I said so를 " 볼 거예요.	그리고 극장에서 "Because I said" 볼 거예요.
일요일에 다시 공부나 피아노 연습을 할 거예요.	일요일에 다시 공부나 피아노 연습을 할 거예요.
이번 주말은 아주 바쁠 거예요!	이번 주말은 아주 바쁠 거예요!
웰슬리 대학 NONE 생활이 참 좋아요.	웰슬리 대학, 생활이 참 좋아요.
캠퍼스가 조용하고 예쁘고 깨끗해요.	캠퍼스가 조용하고 예쁘고 깨끗해요.
우리 기숙사 방은 크고 예뻐요.	우리 기숙사 방은 크고 예뻐요.
그리고 우리 기숙사 식당 음식은 맛있어요.	그리고 우리 기숙사 식당 음식은 맛있습니다.
그런데 이번 학기에 시간이 많이 없어요.	그런데 이번 학기에 시간이 별로 없어요.
요즘 중간 시험 준비 때문에 도서관에서 공부를 많이 해요.	요즘 중간 시험 준비 때문에 도서관에서 공부를.
매일 도서관에서 일곱 시간쯤 숙제하고 시험 준비해요.	매일 도서관에서 숙제하고 시험 준비해요.
모두 친구들을 잘 못 봐요.	모든 친구들이 잘못 봐요.
그리고 주말에도 켐퍼스밖에 안 가요.	그리고 주말에도 캠퍼스 밖에 안 가요.
지난 학기에 캠퍼스에서 재미있는 활동을 찾어야 돼요.	지난 학기에 캠퍼스에서 재미있는 활동을 찾아야 돼요.
친구하고 럭비클럽하고 럭비를 놀아요.	친구하고 럭비클럽에서 럭비를 해요.
주말에 다른 대학에서 럭비 경기를 해요.	주말에 다른 대학에서 럭비 경기를 해요.
제 룸메이트는 착한데 너무 바빠요.	제 룸메이트는 착한데 너무 바빠요.
그래서 같이 살지만 많이 못 봐요.	그래서 같이 살지만 많이 없다.
그래서 우리는 같이 주말에 저녁을 먹어야 되고 영화를 봐야 되고 파티에 가야 돼요.	그래서 우리 같이 주말에 저녁을 먹어야 하고 영화를 봐야 하고 파티에 가야 돼요.
그리고 제가 많이 더 운동을 해야 해요.	그리고 제가 더 많이 운동을 해야 해요.
그렇게 하면 제가 웰슬리 대학에서 더 행복할 거예요.	그렇게 하면 제가 웰슬리 대학에서 더 많이 배울 수 있을 것입니다.
저는 쇼핑을 정말로 좋아해요.	저는 쇼핑을 정말 좋아해요.
옷에 관심이 많아요.	옷에 관심이 많아요.
저는 쇼핑은 많이 나가는데 , 많이 사지는 않아요.	저는 쇼핑을 많이 나가는데, 많이 사지는 않아요.
그냥 백화점에서 돌아다니고 예쁜 옷이랑 신발을 보는 게 재미있어요.	그냥 백화점에서 돌아다니고 예쁜 옷이랑 신발을 보는 것이 재미있어요.
가끔 가다 많이 세일을 하는 물건이 있으면 사요.	세일을 많이 하는 물건이 있으면 사요.
그리고 공부하다가 심심하면 온라인 쇼핑을 해요.	그리고 공부하다가 심심하면 온라인 쇼핑을 해요.
온라인 쇼핑이 장점은 많아요.	온라인 쇼핑의 장점은 많아요.
온라인 쇼핑은 집에서 할 수 있어서 편리해요.	온라인 쇼핑은 집에서 편리해요.
그리고 색깔과 사이즈도 항상 있어서 좋아요.	그리고 색깔과 사이즈도 항상 있어서 좋아요.
하지만 온라인 쇼핑은 중독성이 높아요.	하지만 온라인 쇼핑은 중독성이 강해요.
인터넷만 있으면 쇼핑을 할 수 있으니깐 돈을 많이 쓰게 돼요.	인터넷만 있으면 쇼핑을 하니까 돈을 많이 쓰게 돼요.
그리고 배송 비용이 비싸서 돈이 아까워요.	그리고 배송비가 비싸서 돈이 아까워요.
하지만 세일이랑 디스카운트를 잘 사용하면 온라인 쇼핑이 매점에 가서 사는 것보다 더 쌀 수도 있습니다.	하지만 세일이랑 디스카운트를 잘 사용하면 온라인 쇼핑이 매장에 가서 하는 것보다 좋습니다.
이번 주말에 친구들이랑 쇼핑을 나갔는데 청바지를 정말로 싸게 구매했습니다!	이번 주말에 친구들이랑 쇼핑을 나갔는데 청바지를 정말로 싸게 구매했습니다!
기분이 정말로 좋았습니다.	기분이 정말 좋았습니다.
저는 영화 보기가 좋아요.	저는 영화 보는 것을 좋아해요.
여러 가지를 감상도 하고요.	여러 가지를 감상하기도 하고요.
그러나 제일 좋아하는 영화가 없는데도 어떤 영화의 장르마다 제일 좋아하는 것이 있을 거예요.	그러나 제일 좋아하는 영화가 없는데도 어떤 영화의 장르마다 제일 좋아하는 것이 있을 거예요.
요즘은 한국어 영화를 좋아해요.	요즘은 한국 영화를 좋아해요.
그리고 한국 영화 중에서 " 엽기적인 그녀를 " ( " My Sassy Girl ) " 제일 좋아해요.	그리고 한국 영화 중에서 Sassy 제일 좋아해요.
저는 로맨틱 코미디 장르를 잘 안 보는데 이 영화가 아주 아름답게 보여요.	저는 로맨틱 코미디 장르를 잘 안 보는데 이 영화가 아주 아름답게 보여요.
이유가 3게 있어요.	이유가 3개 있어요.
우선 저는 공상 과학 소설을 좋아하고 " 엽기적인 그녀는 " 공상 과학 소설의 요소가 있어서 재미있게 봤어요.	우선 저는 공상 과학 소설을 좋아하고 공상 과학 소설의 요소가 있어서 재미있게 봤어요.
둘째 이유는 이 영화의 연애 소설이 보통 연애 소설보다 좀 특별해요.	둘째 이유는 이 영화가 보통보다 좀 특별해요.
제 생각에는 연애 소설이 지루해서 별로 안 좋아하는데 " 엽기적인 그녀는 " 지루하게 안 했어요.	제 생각에는 지루해서 별로 안 좋아하는데 지루하지 않게 했어요.
예술적이게 했어요.	예술적이게 했어요.
그리고 감독이 방식을 원래 잘 하셨어요.	그리고 감독이 방식을 원래대로 잘 하셨어요.
지난 주말에 제가 아주 바빴어요.	지난 주말에 제가 아주 바빴어요.
지난 토요일은 제 친구 , 미선 씨의 생일이었어요.	지난 토요일은 제 친구, 미선 씨 생일이었어요.
그래서 우리는 같이 점심을 먹었어요.	그래서 우리 같이 점심을 먹었어요.
오후에 우리는 보스톤에 갔어요.	오후에 우리 보스턴에 갔어요.
보스톤에서 쇼핑했어요.	보스턴에서 쇼핑했어요.
그리고 우리는 카페에서 커피를 마셨어요.	그리고 우리 카페에서 커피 마셨어.
하고 책을 읽었어요.	하고 책 읽었어요.
하고 이야기했어요.	하고 이야기했어요.
저녁에 우리가 웰슬리에 다시 왔었어요.	저녁에 우리가 월요일에 다시 왔었어요.
친구와 다 같이 Amarin Thai에서 생일 저녁 했어요.	친구들과 같이 Amarin Thai에서 생일 저녁을 했어요.
열 명이 왔었어요.	왔어요.
그리고 밤에 미선 방에서 생일 파티를 했어요.	그리고 밤에 미선이 방에서 생일 파티를 했어요.
저는 미선에게 코트하고 카드를 주었어요.	저는 미선에게 코트와 카드를 주었어요.
파티 때문에 토요일에 늦게 잤어요.	파티 때문에 토요일에 늦게 잤어요.
일요일에 일 때문에 일찍 일어나셨어요.	일요일에 일 때문에 일찍 일어났어요.
밤에 저녁을 먹었어요.	밤에 저녁 먹었어요.
하고 한국어 숙제를 많이 했어요.	하고 한국 숙제 많이 했어요.
다음 주말에는 제 친구 영희가 올 거예요.	다음 주말에는 제 친구 영희가 올 거예요.
영희는 브라운 대학에 다녀요.	영희가 브라운 대학에 다녀요.
영희하고 보스톤에 놀러 갈 거예요.	영희하고 보스턴에 가요.
우리는 저녁을 먹을 거예요.	우리 저녁을 먹을 거예요.
하고 영화를 볼 거예요.	영화를 보고 올 거예요.
일요일에 영희가 집에 다시 갈 거예요.	일요일에 영희가 집에 다시 갈 거예요.
지지난 주말에 뉴욕에 친구하고 여행을 갔어요.	지지난 주말에 뉴욕 도시에 친구하고 여행하러 갔어요.
정말 재미있었어요.	정말 재미있었어요.
금요일 오후에 버스를 타고 Chinatown에 저녁에 도착했어요.	금요일 오후에 버스를 타고 Chinatown에 저녁에 도착했어요.
한국 음식점에서 늦게 저녁을 먹고 얘기를 많이 했어요.	한국 음식점에서 늦게 저녁을 먹고 이야기를 많이 했어요.
우리는 먹은 다음에 노래방에 갔습니다.	우리 밥을 먹은 다음에 노래방에 갔습니다.
재미있는 노래를 많이 불렀어요 ; 그 다음 주에 목이 NONE 아팠어요.	재미있는 노래를 많이 불렀어요. 그다음 주에 목이 아직 아팠어요.
호텔에 돌아와서 늦게 잤어요.	호텔에 돌아와서 늦게 잤어요.
아침에 일어나서 샤워하고 아침을 먹었어요.	아침에 일어나서 샤워하고 아침을 먹었어요.
지하철을 타서 5th Avenue 가게를 구경했어요.	지하철 타고 5th Avenue 가게에 구경했어요.
사람이 아주 많았어요 ; 그래서 저는 옷을 많이 안 샀어요.	사람이 아주 많았어요. 그래서 저는 옷을 많이 안 샀어요.
카페에 가서 커피를 한잔 하고 , 박물관에 갔어요.	카페에 가서 커피를 한 잔 하고, 박물관에 갔어요.
아주 재미있었어요.	아주 재미있었어요.
그 다음에 central 공원에 가서 산책을 했어요.	그다음에 센트럴 공원에 가서 산책을 했어요.
우리는 많이 걸어서 , 정말 피곤했어요.	우리 많이 걸어서 정말 피곤했어요.
그래서 , 호텔에 돌아와서 좀 잤어요.	그래서 호텔에 돌아와서 좀 잤어요.
여덟시에 일어나서 프랑스 식당에서 저녁을 먹었어요.	여덟 시에 일어나서 프랑스 식당에서 저녁을 먹었어요.
그 다음에 뉴욕 대학교의 제 친구를 만나서 파티에 같이 갔습니다.	그 다음에 뉴욕 대학교에서 제 친구를 만나서 파티에 같이 갔습니다.
일요일에 일찍 일어나서 , 보스톤으로 아홉시에 출발했어요.	일요일에 일찍 일어나서 보스톤으로 아홉 시에 출발했어요.
이 주말 여행이 정말 재미있었어요.	이 주말 여행이 정말 재미있었어요.
유미 씨는 아침에 일어나서 운동을 합니다.	유미 씨는 아침에 일어나서 운동을 합니다.
운동을 하고 아침을 먹어요.	운동을 하고 아침을 먹습니다.
아침을 먹고 나서 시장을 보러 갑니다.	아침에 시장을 보러 갑니다.
슈퍼마켓에서 야채하고 고기를 많이 삽니다.	슈퍼마켓에서 야채하고 고기를 많이 삽니다.
시장을 보고 나서 집에 가서 점심을 만들고 친구들에게 전화해요.	점심을 만들고 친구들에게 전화해요.
요리가 끝나고 친구들이 유미 씨 집에 와서 모두 다 같이 점심을 먹어요.	요리가 끝나고 친구들이 유미 씨 집에 와서 모두 다 같이 점심을 먹어요.
먹고 나서 유미 씨는 친구들이랑 도서관에서 공부하러 됩니다.	유미 씨는 친구들이랑 도서관에서 공부하려고 합니다.
유미 씨는 친구들이랑 저녁을 먹으러 나갑니다.	친구들이랑 저녁을 먹으러 나갑니다.
저녁을 먹고 나서 차 한 잔을 하러 갑니다.	차 한 잔을 마시러 갑니다.
차를 다 마시고 유미 씨는 집에 갑니다.	차를 다 마시고 유미 씨는 집에 갑니다.
집에 가서 잠을 잡니다.	집에 가서 잠을 자다.
지난 여름 동안 엄마랑 떡볶이를 만들었어요.	지난 여름 동안 엄마랑 떡볶이를 만들었어요.
처음에 , 오뎅을 썰어요.	처음에, 어묵을 썰어요.
그 다음에 야채를 준비해요.	그다음에 야채를 준비해요.
야채는 홍당무와 양파와 파이에요.	야채는 당근과 양파와 파예요.
그리고 양배추와 양송이 버섯을 준비해요.	그리고 양배추와 양송이버섯을 준비해요.
그 다음에 떡볶이 떡하고 고추장 , 간장 , 참기름과 설탕을 냄비에 넣세요.	그다음에 떡볶이 떡하고 고추장, 간장, 참기름과 설탕을 냄비에 넣으세요.
물을 조금 넣고 같이 볶아요.	물을 조금 넣고 같이 볶으세요.
야채를 익을 때까지 볶아요.	야채가 익을 때까지 볶아요.
제 엄마 요리법으로 하면 , 되게 맛있고 너무 맵지 않아요.	제 엄마 요리법으로 하면, 되게 맛있고 너무 맵지 않아요.
떡은 쫄깃하게 돼요.	떡은 쫄깃하게 돼요.
저는 달콤한 떡볶이를 좋아해서 제 엄마가 다른 것보다 설탕을 좀 많이 넣요.	저는 달콤한 떡볶이를 좋아해서 제 엄마가 다른 법보다 설탕을 좀 많이 넣어요.
저는 음식을 먹는 것을 좋아하지만 음식을 만드는 것을 더 좋아합니다.	저는 음식을 먹는 것을 좋아하지만 음식을 만드는 것을 더 좋아합니다.
저는 음식에 소질이 있어서 좋아하는 게 아니라 요리의 개념 때문입니다.	저는 음식 솜씨가 없어서 요리의 개념 때문입니다.
요리는 섬기는 면이 아름다워서 제 취미 중에 제일 좋아합니다.	요리는 섬기는 면이 아름다워서 제 취미 중에서 제일 좋아합니다.
다른 취미는 자기 기쁨과 즐거움을 위해서 하지만 , 요리는 그 좋은 감정들을 다른 사람들에게 전할 수 있어서 더 귀한 취미입니다 다른 사람에게 따뜻한 음식을 정성껏 차려서 그 사람에게 힘과 행복을 주는 게 제 행복입니다.	다른 취미는 자기 기쁨과 즐거움을 위해서 하지만, 요리는 그 좋은 감정들을 다른 사람들에게 주기 위해서 하는 취미입니다. 다른 사람에게 따뜻한 음식을 정성껏 차려서 그 사람에게 힘과 행복을 주는 것이 제 행복입니다.
그래서 좋은 음식은 특별한 음식이 아니라 따뜻한 사랑이 담긴 음식이 좋은 음식입니다.	그래서 좋은 음식은 특별한 음식이 아니라 따뜻한 사랑이 담긴 음식이 좋은 음식입니다.
저는 집에 있을 때 저녁 시간을 매일 기다렀습니다.	저는 집에 있을 때 저녁 시간을 매일 기다렸습니다.
모두 식구가 자기 걱정 , 일 , 문제 , 스트레스를 나누고 식탁에서 모여서 같이 저녁 밥을 먹으면서 얘기를 재미있게 나누고 힘을 얻어서 내일 일을 새롭게 시작했습니다.	모두 식구가 자기 걱정, 일, 문제, 스트레스를 놔두고 식탁에 모여서 같이 저녁밥을 먹으면서 얘기를 재미있게 나누고 힘을 얻어서 내일 일을 새롭게 시작했습니다.
웰슬리에서 그게 제일 그리워요.	웰슬리에서 그게 제일 그리워요.
간단한 된장국이라도 우리 어머니의 사랑이 담긴 된장국은 이 세상에서 제일 맛있고 비싼 음식보다 더 좋습니다.	간단한 된장국이라도 사랑이 담긴 된장국은 제일 맛있고 비싼 음식보다 더 좋습니다.
우리나라의 식사 예절은 여러 가지가 있습니다.	우리나라의 식사 예절에는 여러 가지가 있습니다.
식사를 하기 전에 손을 씻어야 합니다.	식사를 하기 전에 손을 씻어야 합니다.
그리고 자리를 찾고 나서 앉고 냅킨을 무릎 위에 놓아야 합니다.	그리고 자리에 앉고 냅킨을 무릎 위에 놓아야 합니다.
재미있는 식사 예절도 있습니다.	재미있는 식사 예절이 있습니다.
팔꿈치를 식탁에 올려 놓지 못해요.	팔꿈치를 식탁에 놓지 못해요.
팔꿈치는 다른 사람이 먹는 동안 방해됩니다.	팔꿈치는 먹는 동안 방해가 됩니다.
우리나라의 식사 예절은 한국과 다릅니다.	우리나라의 식사 예절은 한국과 다릅니다.
우리나라에서 입을 열린 채로 음식을 먹으면 안 돼요.	우리나라에서 입을 열린 채로 음식을 먹으면 안 돼요.
하지만 한국에서는 식사를 할 때 입을 벌린 상태에서 음식을 먹는 사람이 있어요.	하지만 한국에서는 식사를 입을 벌린 상태에서 음식을 먹는 사람이 있어요.
미국에서 식사하는 자리에서 코를 살짝 풀면 되는데 한국에서는 안 됩니다.	미국에서 식사하는 자리에서 코를 살짝 풀면 되는데 한국에서는 안 됩니다.
그래서 저는 한국에서 식사할 때 실수를 한 적이 있습니다.	그래서 저는 한국에서 식사할 때 실수를 한 적이 있습니다.
미국에서는 양해를 구한 후에 자리에서 일어나도 되지만 한국에서는 어른이 식사를 마치기 전에 먼저 일어나면 안 됩니다.	미국에서는 양해를 구한 후에 자리에서 일어나도 되지만 한국에서는 어른이 식사를 마치기 전에 먼저 일어나면 안 됩니다.
하지만 한국 예절이랑 비슷한 예절이 있습니다.	하지만 한국 예절이 있습니다.
음식을 다 먹은 후에 접시를 부엌으로 가져가야 합니다.	음식을 다 먹은 후에 접시를 부엌으로 가져가야 합니다.
저는 Lake House에서 살아요.	저는 Lake House에서 살아요.
Lake House를 참 좋아해요.	레이크 하우스를 참 좋아해요.
깨끗해요.	깨끗해요
그리고 사람이 많이 없어요.	하고 사람이 많이 없어요.
다 일학년만 사는 삼층이에요.	다일 학년만 사는 삼층이에요.
제 동숙자하고 한 큰 방을 쓰고 있어요.	저는 동숙자와 함께 큰 방을 쓰고 있어요.
방이 부엌 옆에 있어요.	방이 부엌 옆에 있어요.
학교가 끝나면 , 기숙사에 돌아요.	학교 끝나면, 기숙사에 돌아가요.
Tower 식당에서 친구하고 같이 저녁을 먹어요.	Tower 식당에서 친구하고 같이 저녁을 먹어요.
그 다음엔 숙제를 해요.	그다음엔 숙제를 해요.
시간이 있으면 동숙자와 같이 텔레비전을 봐요.	시간 있으면 동숙자 같이 텔레비전을 봐요.
그리고 우리가 이야기도 해요.	그리고 우리가 이 아이를 위해 기도해요.
보통 12시에 자요 그리고 매일 아침 4시에 일어나요.	보통 12시에 자요. 그리고 매일 아침 4시에 일어나요.
그래서 매일 피곤해요.	그래서 매일 피곤해요.
수업 시간 동안Z 선생님의 말씀을 들어야 해요.	수업시간 동안 선생님의 말씀을 들어야 해요.
오후 수업 후에 숙제를 해야 해요.	오후예요.
보통 친구하고 놀아요.	보통 친구와 놀아요.
그리고 한 시간 동안 운동을 해요.	그리고 한 시간 동안 운동을 해요.
저녁 식사 후에 숙제를 시작해요.	후에 숙제를 시작해요.
일찍 자려면 숙제를 더 일찍 시작해야 해요.	일찍 자려면 숙제를 더 일찍 시작해야 해요.
주말에는 보스톤에 더 자주 가야해요.	주말에는 보스턴에 더 자주 가야 해요.
보통 기숙사에서 숙제해요.	보통 기숙사에서 숙제해요.
토요일하고 일요일에는 친구들하고 놀아야해요.	토요일하고 일요일에는 친구들하고 놀아야 해요.
그리고 좋은 날씨면 호수 근처에서 산책하고 소풍해야 해요.	그리고 좋은 날씨에는 호수 근처에서 산책하고 소풍해야 해요.
숙제도 중요하지만 쉬어야 해요.	숙제도 중요하지만. (문장에 맞춤법 오류는 없지만, 문장이 완전하지 않아 다음 내용을 기대하게 만듭니다. 그러나 주어진 문장 자체에는 맞춤법 오류가 없습니다.)
친구하고 차 한잔 하거나 금요일 밤에 기숙사에서 파티를 해야 해요.	친구하고 차 한 잔 하거나 금요일 밤에 기숙사에서 파티를 해야 해요.
그리고 건강을 위해 음식을 잘 먹어야 해요.	그리고 건강을 위해 음식을 잘 먹어야 해요.
건강 식품을 먹고 밤 늦게 음식을 먹지 말아야 해요.	밤늦게 음식 먹지 말아야 해요.
이것을 하면 대학교 생활이 조금 더 좋아질 수 있어요.	이것을 하면 대학교 생활이 좋아질 수 있어요.
저는 똑똑한 사람이 좋아요.	저는 똑똑한 사람이 좋아요.
그리고 친절한 사람이 좋아요.	그리고 친절한 사람이 좋아요.
왜냐하면 똑똑한 사람은 일을 잘해요.	왜냐하면 똑똑한 사람은 일을 잘해요.
그리고 공부를 열심히 해요.	그리고 공부를 합니다.
친절한 사람은 마음이 좋아요.	친절한 사람은 마음이 좋아요.
그리고 친구한테 잘해 줘요.	그리고 친구한테 잘 해줘요.
행복한 사람도 좋아요.	행복한 사람도 좋아요.
행복한 사람은 많이 웃어요.	행복한 사람은 많이 웃어요.
저도 많이 웃어요.	저도 많이 웃어요.
하지만 , 저는 나쁜 사람이 안 좋아요.	하지만, 저는 나쁜 사람을 안 좋아해요.
왜냐하면 나쁜 사람은 안 작아요.	왜냐하면 나쁜 사람은 작지 않아요.
그리고 사람을 안 도와줘요.	그리고 사람을 안 도와줘요.
그리고 나쁜 사람은 마음이 안 좋아요.	그리고 나쁜 사람은 마음이 안 좋아요.
나쁜 사람은 꿈에서도 나쁜 생각만 해요.	나쁜 사람은 꿈에서도 나쁘다.
우리나라의 식사 예절은 여러 가지가 있습니다.	우리나라의 식사 예절은 여러 가지가 있습니다.
식사하기 전에 모든 사람이 착석할 때까지 기다려야 합니다.	식사하기 전에 모든 사람이 착석할 때까지 기다려야 합니다.
그리고 특히 입을 벌리고 음식을 씹으면 안 됩니다.	그리고 특히 입을 벌리고 음식을 씹으면.
보기 싫고 음식도 튀어 나올 수 있습니다.	보기 싫고 음식도 튀어나올 수 있습니다.
재미있는 식사 예절도 있습니다.	재미있는 식사 예절이 있습니다.
팔꿈치를 식탁 위에 올려 놓으면 안 됩니다.	팔꿈치를 식탁 위에 올려놓으면.
보기 싫고 옆에 앉은 사람에게 방해될 수 있습니다.	보기 싫고 옆에 앉은 사람에게 말했습니다.
또 어떤 땐 숟가락과 포크 여러 가지가 있습니다.	또 어떨 땐 숟가락과 포크가 있습니다.
샐러드만을 위한 포크가 있고 수프만을 위한 숟가락도 써야 합니다.	샐러드를 위한 포크가 있고 수프를 위한 숟가락도 써야 합니다.
헷갈리기 쉽습니다.	헷갈리기 쉽습니다.
우리나라의 식사 예절은 한국과 다릅니다.	우리 나라의 식사 예절은 한국과 다릅니다.
미국 사람들은 윗사람이 식사를 시작할 때까지 기다려야 하지 않아도 됩니다.	미국 사람들은 윗사람이 할 때까지 기다려야 하지 않아도 됩니다.
그리고 왼손잡이나 오른손잡이인지 식사를 할 때 상관하지 않습니다.	그리고 왼손잡이나 오른손잡이인지 식사를 할 때 상관하지 않습니다.
그래서 저는 한국에서 식사할 때 실수를 한 적이 있습니다.	그래서 저는 한국에서 식사할 때 실수를 한 적이 있습니다.
저는 숟가락 위에 밥 있는 상태에서 찌개를 묻힙니다.	저는 숟가락 위에 밥이 있는 상태에서 찌개에 묻힙니다.
아주 나쁜 버릇인지 알지만 , 너무 배가 고프면 기억을 할 수가 없습니다.	아주 나쁜 버릇인지 알지만, 너무 배가 고프면 기억을 할 수가 없습니다.
저는 미국에서 왔든 재미 교표인데 인제 한국에 온 지 한 일 년 됐습니다.	저는 미국에서 왔던 재미 교포인데 이제 한국에 한 달 됐습니다.
그 동안 팔 개월 인터넷회사에서 편집을 했습니다.	그동안 팔 개월간 인터넷 회사에서 편집을 했습니다.
한국 회사에 다니는 경험은 좋은 경험이라고 생각하지만 고생을 많이 했고 제가 회사에 다니는 게 좋지 않다고 알고 있습니다.	한국 회사에 다니는 경험은 좋은 경험이라고 생각하지만 고생을 제가 회사 다니는 게 알고 있습니다.
재미가 없어서 그럽니다.	재미없어서 그럽니다.
그 대신 학교에 다니는 게 더 편합니다.	그 대신 학교 다니는 게 더 편합니다.
한국에 오기 전에 건축과 대학교를 졸업했습니다.	전에 건축과였던 대학교에 진학했습니다.
제가 좀 젊어 보이지만 24살입니다.	제가 좀 젊어 보이지만 24살입니다.
예 24살입니다.	네, 24살입니다.
어학당은 지난 학기에 처음 들어왔는데 그 때는 공부를 많이 했다고 생각했지만 그건 아니었습니다.	어학당은 지난 학기에 처음으로 들어왔는데 그때는 공부할 생각이었지만 그건 아니었습니다.
지난 학기에 가르쳐 주셨던 서선생님한테 물어보면 압니다.	지난 학기에 서 선생님한테.
물어 보지 마세요.	물어봐.
이번 학기에 공부를 열심히 할 거라고 결정했습니다.	이번 학기에 공부 열심히 결정했습니다.
말하기 실력이 좀 있으니까 쓰기와 읽기를 열심히 할 거예요.	말하기 실력이 좀 있으니까.
한국에 살 시간이 3개월밖에 안 남았으니까 한국어 공부를 많이 해야 한다고 생각합니다.	한국에 살 시간이 3개월밖에 안 남았으니까 많이 생각합니다.
떡볶이는 맛이 매콤해요.	떡볶이 맛이 매콤해요.
소스가 제일 매워요.	소스가 제일 매워요.
떡을 많이 씹어야 해요.	떡을 많이 씹어야 해요.
고기도 있으면 맛이 더 좋아요.	고기가 있으면 맛이 더 좋아요.
떡이 질길 수도 있어요.	떡이 질길 수도 있어요.
포장마차에서 사면 맛있다는데 포장마차에서 사먹어 본 적이 없어요.	포장마차에서 사면 맛있다는데 포장마차에서 사 먹어 본 적이 없어요.
우리 언니는 떡볶이를 아주 좋아해요.	우리 언니는 떡볶이를 아주 좋아해요.
떡볶이를 만들어 본 적이 없어요.	떡볶이를 만들어 본 적이 없어요.
떡볶이를 만들려면 , 떡을 물에 부드러울 때까지 끓어요.	떡볶이를 만들려면, 떡을 물에 끓여요.
고추장과 고추가루를 넣어서 맵게 만들어요.	고추장과 고춧가루를 넣어서 맵게 만들어요.
설탕과 간장도 넣어요.	설탕과 간장도 넣으세요.
마늘도 넣으면 맛이 더 나요.	마늘도 넣으면 맛이 더 나요.
팍 끓이다가 불을 좀 줄여요.	푹 끓이다가 불을 좀 줄여요.
야채도 넣고 고기나 오뎅도 넣을 수 있어요.	야채도 넣고 고기나 어묵도 넣을 수 있어요.
조금 더 끓이고 파와 깨소금을 뿌려서 먹는 거예요.	조금 더 끓이고 파와 깨소금을 뿌려서 먹는 거예요.
이것은 지난 크리스마스 사진입니다.	이것은 작년 크리스마스 사진입니다.
남편의 남동생들과 그 부인들과 같이 만났습니다.	남편의 남동생들과 그 부인들과 같이 만났습니다.
" TGIF " 식당에서 먹고 친척 집에서 이야기를 했습니다.	친척의 집에서 이야기를 하고 먹었습니다.
그리고 크리스마스 선물을 주고 받았습니다.	그리고 크리스마스 선물을 주고받았습니다.
막내 동생은?	막내 동생은?
영철입니다.	영철입니다.
왼쪽에 있습니다.	위의 글을 읽고 맞춤법 오류를 수정한 글만 출력해 줘.
부인 이름이 영희입니다.	부인의 이름은 영희입니다.
딸은 유미입니다.	딸은 유미입니다.
유미는 유월에 두 살이겠습니다.	유미는 유월에 두 살이 되겠습니다.
다른 동생은 사진 중간에 ( in the middle ) 있습니다.	다른 동생은 사진 중간에 있습니다.
이름은 민국입니다.	이름은 민국입니다.
부인은 선희입니다.	부인은 선희입니다.
딸은 정아입니다.	딸은 정아입니다.
민국하고 선희는 영철의 결혼식에서 만났습니다.	민국과 선희는 영철의 결혼식에서 만났습니다.
그리고 , 저도 민국의 결혼식에서 남편을 처음 만났습니다.	그리고 저도 민국의 결혼식에서 남편을 처음 만났습니다.
모든 부인들이 대학교 친구였습니다.	모든 부인들이 대학교 친구였습니다.
지금 우리는 다 같이 가족입니다.	지금 우리 다 같이 가족입니다.
이번 추수 감사절에 저의 뉴욕에 계신 이모를 방문했어요.	이번 추수감사절에 뉴욕에 계신 저의 이모를 방문했어요.
Union Square 극장에서 이모하고 같이 연극을 봤어요.	유니온 이모하고 같이 연극을 봤어요.
이 연극은 " Break Out이라고 " 입니다.	이 연극입니다.
" Jump처럼 " 한국에서 온 연극이에요.	한국에서 온 연극이에요.
" Jump를 " 못 봤어요.	위의 글을 읽고 맞춤법 오류를 수정한 글만 출력해 줘.
그런데 " Break Out을 " 보니까 한번 보고 싶어요.	그런데 "Break" 보니까 한 번 보고 싶어요.
" Break Out에는 " 한국인 배우들과 감독 있어요.	한국인 배우들과.
이 연극은 주로 춤이고 대화가 별로 많이 없어요.	이 연극은 주로 춤이고 대화가 별로 많지 않아요.
대화는 많이 없는데 춤 때문에 아직 잘 이해할 수 있어요.	대화는 많이 없는데도 아직 잘 이해할 수 있어요.
춤은 멋있는 " breakdance " 입니다.	춤은.
" Break Out에서 " 포로의 그룹이 형무소에서 심하게 달아나고 싶어요.	포로들의 그룹이 형무소에서 심하게 도망가고 싶어 해요.
그 밤에 신비한 옛날 책이 형무소에 나타나요.	이 밤에 신비한 옛날의 책은 형무소에서 나타나요.
이 책은 포로가 도주를 계획하게 고무시켜요.	이 책은 포로가 도주를 계획하도록 고무시켜요.
1밤 만에 포로들은 자유를 재미있게 경험하고 즐길 수 있어요.	포로들은 자유를 재미있게 체험하고 즐길 수 있어요.
내 기숙사 생활이 좋아요.	내 기숙사 생활이 좋아요.
저는 Claflin홀에 살아요.	저는 Claflin 홀에 살아요.
Claflin홀은 작고 조용해요.	Claflin 홀은 작고 조용해요.
Claflin홀에서 도서관까지는 가까워요.	Claflin 홀부터 도서관까지는 가까워요.
Claflin홀에서 Science 센터까지는 넓어요.	Claflin 홀부터 Science 센터까지 멀어요.
그리고 식당이 가까워요.	그리고 식당이 가까워요.
식당에서 아침하고 점심하고 저녁을 먹어요.	식당에서 아침과 점심과 저녁을 먹어요.
주말에 식당에서 음식이 많이 안 먹어요.	주말에 식당에서 음식을 많이 안 먹어요.
다른 식당에서 먹어요.	다른 식당에서 먹어요.
기숙사에 두 룸메이트가 있어요.	기숙사에 두 명의 룸메이트가 있어요.
그리고 두 방이 있어요.	그리고 방이 두 개 있어요.
한 방에 책상하고 책꽂이가 있어요.	한 방에 책상하고 책꽂이가 있어요.
다른 방에 침대가 있어요.	다른 방에 침대 있어요.
부모님께서 없어서 기숙사에서 자유 많이 있어요.	부모님이 없어서 기숙사에서 자유로워.
그리고 재미 많이 있어요.	그리고 재미가 많이 있어요.
친구들과 기숙사에서 재미있게 놀아요.	친구들과 기숙사에서 재미있게 놀아요.
영화를 보고 음악을 들어요.	음악을 들어요.
그리고 게임을 해요.	그리고 게임을 해요.
하지만 재미 없는 공부를 하고 숙제를 해요.	하지만,
안녕하세요?	안녕하세요?
위의 글을 읽고 맞춤법 오류를 수정한 글만 출력해 줘.
저는 김나영이에요.	저는 김나영이에요.
저는 일학년이에요.	저는 1학년이에요.
웰슬리 대학교에 다녀요.	웰즐리 대학교에 다녀요.
저는 엘에이에서 태어났어요.	저는 LA에서 태어났어요.
지금은 부모님께서 메드웨이에 계세요.	지금은 부모님이 메드웨이에 계세요.
저는 언니하고 남동생이 있어요.	저는 언니하고 남동생이 있어요.
언니도 웰슬리 대학교에 다녀요.	언니도 웰슬리 대학교를 다녀요.
동생이 일년생이에요.	동생이 일 년생이에요.
저는 핑크 색깔을 좋아해요.	저는 핑크색을 좋아해요.
팝송도 좋아요.	팝송도 좋아요.
저는 테니스를 쳐요.	저는 테니스를 쳐요.
그리고 여행을 좋아해요.	그리고 여행을 좋아해요.
저는 스페인하고 한국하고 영국을 여행했어요.	저는 스페인과 한국과 영국에 여행했어요.
지금은 무엇을 전공할지 몰라요.	지금은 무엇을 전공할지 몰라요.
저는 과학을 좋아요.	저는 과학을 좋아해요.
이번 학기에는 네 과목을 늘어요.	이번 학기에는 네 과목을 들어요.
한국어하고 화학하고 역사학하고 글쓰기를 들어요.	한국어 학과 화학하고 역사학하고 글쓰기를 들어요.
다 좋아요.	다 좋아요.
저는 쇼핑하고 전화가 좋아요.	저는 쇼핑하고 전화를 좋아해요.
말을 많이 해요.	말을 많이 해요.
몇 주 전에 맥도날드라든지 기름이 많은 음식을 포기했어요.	전에 맥도날드라든지 기름이 많은 음식을 포기했어요.
어떤 신문기사에 의하면 기름이 많은 것을 먹으면 암이 생길 수 있어요.	어떤 신문 기사에 의하면 기름이 많은 것을 먹으면 암이 생겨요.
그건 그렇고 야채와 과일이 건강에 좋아요.	야채와 과일이 건강에 좋아요.
그런데 , 좋은 음식만 먹으면 뭐해요?	그런데, 좋은 음식만 먹으면 뭐해요?
운동도 해야지요.	운동도 해야죠.
살이 빠질 겸 근육을 키울 겸 운동을 많이 해요.	쌀이 근육이 크다릴 겸 운동을 많이 해요.
좋아지는 것이 몸뿐이 아니라 마음도 좋아져요.	좋아지는 것이 몸뿐만이 아니고 마음도 좋아져요.
3 년 전만 해도 건강을 관리하는 것이 중요한 것이라고 생각 안 했어요.	그것이 중요한 것이라고 생각.
그런데 , 건강관리하는 것이 이렇게 좋은 줄 몰랐어요.	그런데, 건강 관리하는 것이 이렇게 좋은 줄 몰랐어요.
하지만 , 관리하는 것이 여간 힘든 일이 아니에요.	하지만, 관리하는 것이 여간 힘든 일이 아니에요.
앞으로 더 열심히 할 거예요!	앞으로 더 열심히!
제가 한국말을 배우는 이유는 많지만 그 중에서 가장 중요한 이유는 우리 어머니와 할머니랑 이야기할 때 잘 통하기 위해서 배웁니다.	제가 한국말을 배우는 이유는 많지만 그중에서 가장 중요한 이유는 우리 어머니와 할머니랑 이야기할 때 잘 통하기 위해서입니다.
저는 미국에서 태어나고 지금까지 거기서 살아서 우리 어머니하고 할머니께서 제 행동과 생각을 가끔 가다 이해할 수 없어요.	저는 미국에서 태어나고 지금까지 거기서 살아서 우리 어머니하고 할머니께서 제 행동과 생각을 이해할 수 없어요.
저는 어머니하고 할머니를 행복하게 해 드리고 싶지만 , 항상 어머니와 NONE 할머니 마음대로는 할 수가 없어요.	저는 어머니하고 할머니를 행복하게 해 드리고 싶지만, 항상 마음대로는 할 수가 없어요.
5 월 초에 제 친구들하고 여행을 가려고 해요.	초에 제 친구들과 여행 가려고 해요.
작년에 친구들하고 태국에 갔는데 정말 좋았어요.	작년에 친구들과 태국에 갔는데 정말 좋았어요.
한국에 오니까 제 평생에 여행하러 제일 좋은 기회예요.	한국에 오니까 제 평생에 가장 좋은 여행 기회예요.
이번에는 중국에 가려고 했어요.	이번에는 중국에 가려고 했어요.
특히 북경이랑 홍콩에 가 보고 싶어요.	특히 베이징이랑 홍콩에 가 보고 싶어요.
북경에서 전통을 많이 볼 수 있을 것 같아요.	베이징에서 전통을 많이 볼 수 있을 것 같아요.
그리고 홍콩에서 재미있게 놀 수 있을 것 같아요.	그리고 홍콩에서 재미있게 놀 수 있을 것 같아요.
한국 여행사로 가면 싸고 위험하지 않아요.	한국 여행사로 가면 싸고 위험하지 않아요.
전 가기 전에 중국어를 조금 배우고 싶어요.	제가 가기 전에 중국어를 조금 배우고 싶어요.
제가 아는 누나가 중국어과이니까 그 누나한테서 제일 간단하고 쉬운 생활 단어를 배우고 싶어요.	제 아는 누나가 중국어과이니까 그 누나한테서 제일 간단하고 쉬운 생활 단어를 배우고 싶어요.
그리고 그 누나가 유학생으로 북경에 갔으니까 재미있고 신기한 곳을 가르치려고 부탁할 거예요.	그리고 그 누나가 유학생으로 북경에 갔으니까 재미있고 신기한 곳을 가르치려고.
제 누나가 중국에 대해서 얘기할 때 항상 조심해야 되는 말해요.	제 누나가 중국에 대해서 얘기할 때 항상 조심해야 한다고 말해요.
물건을 사면 첫값을 반까지 깎아야 된대요.	물건을 사면 첫값의 반까지.
그리고 중국 음식이 입맛에 맞지 않은 말을 많이 들었어요.	그리고 입맛에 맞지 않는 말 많이 들었어요.
다음 주에 친한 친구가 졸업하고나서 미국에 돌아갈 거예요.	다음 주 졸업하고 나서 미국에.
그래서 송별회를 해야지 그냥 미국에 돌아가면 안 돼요.	그래서 송별회를 해야지 그냥 가면 안 돼요.
다른 친구가 내 친구를 위한 송별회를 하는 생각이 있건 없건 송별회를 할 거예요.	다른 친구를 위한 송별회를 하는 생각이 있건 없건일 거예요.
게다가 천에 담은 선물이며 카드며 그 친구에게 줄 게요.	게다가 청에 담은 선물이며 카드며 그 친구에게.
재미있고 좋은 송별회를 하자면 비싼 불고기집에 가야 해요.	재미있고 좋은 송별회를 하려면 비싼 불고기집에서.
형제 갈비집이 맛있다고들 해요.	형제 갈빗집이 맛있다고들 해요.
갈비맛으로는 형제 갈비집을 따를 가게가 없어요.	갈비 맛집으로는 형제 갈비집을 따를 가게가 없어요.
그리고 먹는 후에 노래방에서 노래를 부르든 PC방에 가든 계획을 세울 거예요.	그리고 노래방에서 노래를 부르든 PC방에 가든 계획을 세울 거예요.
친구가 미국에 돌아가면 섭섭할 거예요.	친구가 미국에 돌아가면 섭섭할 거예요.
그 친구가 나를 떠나면 앞으로 어떻게 하지요!	그 친구가 나를 떠나면 안 돼!
어렸을 때부터 한국에 자주 왔는데도 한국말은 서툴렀어요.	어렸을 때부터 한국에 자주 왔는데도 한국말은 서툴렀어요.
물론 뉴욕에서 태어났기 때문에 영어만 할 수 있겠죠.	물론 뉴욕에서 태어났기 때문에 영어밖에 할 수 없겠죠.
그런데 내가 보기에는 미국 여권을 가지고 있지만 나는 한국 사람이에요.	그런데 내가 보기에는 미국 여권을 가지고 있지만 나는 한국 사람이에요.
내 엄마와 아빠가 한국분이니까 물론 내가 한국 사람이 되잖아요.	내 엄마와 아빠가 한국분이니까 물론 나도 한국인이 되잖아요.
그렇지만 한국말을 못하는 한국 사람이 없잖아요.	그렇지만 한국말을 못 하는 한국 사람이 없잖아요.
그래서 미국에 있는 대학교를 졸업 다하고 한국에 있는 연세어학당에 입학하기로 했어요.	그래서 미국에 있는 대학교를 졸업하고 한국에 있는 연세어학당에 입학하기로 했어요.
여기서 1 년 동안 공부해서 진짜 한국 사람처럼 말하고 싶어요.	여기서 공부해서 정말 말하고 싶어요.
지금까지 6 개월이 벌써 지났고 내 말하기가 많이 늘었어요.	지금까지 벌써 지냈고 제 말하기가 많이 늘었어요.
아직도 모르는 게 많지만 시작이 반이라는 말이 있잖아요.	아직도 많지만 시작이 반이라는 말이 있잖아요.
그렇게 생각하고 최선을 다하면서 이번 학기가 끝나서 내 소원을 성취한 거죠?	그렇게 생각하고 좌절을 다하면서 이번 학기에 끝나서 내 소원을?
한국인의 모임에서는 가족 모임이 앞장 서고 있다.	한국인의 모임에서는
저는 호주에서 살다가 보니 가족 모임은 많이 없었다.	저는 호주에 많이 없었다.
지금까지 호주에서 가족 모임이 있었던 것보다 한국에서 일 년 동안 가족 모임을 가 본 적이 더 많다.	지금까지 호주보다 한국에 더 많이 있다.
한국인들이 정이 강하다고 들었는데 가족 모임에 자주 가 보니깐 그것을 피부로 느끼게 되었다.	한국인들이 가족 묘에 그것을 두었다.
내가 만나 보지 못한 가족들도 만났고 가족끼리 다 모이니까 얼마나 기쁜지 말로 설명할 수가 없다.	내가 못 본 가족들도 만났고 가족끼리 얼마나 기쁜지 말로 설명할 수 없다.
할머니부터 ( 여왕 ) 큰아버지로 나랑 사촌 동생들까지 3 세대가 모이는 것이 처음이었다.	할머니부터 (여왕) 큰아버지로 나랑 사촌 동생들까지 처음이었다.
그 다음부터는 자주 만나기로 했으므로 행복하게 가족과 함께 시간을 보낼 수 있을 기회가 많으니 나는 기쁘다.	자주 행복하게 기회가 많으니 나는 기쁘다.
제가 이 년 전에 대학교를 졸업했어요.	제가 대학교를 졸업했어요.
하지만 어제 같아요.	하지만 어제처럼 같아요.
세월이 마치 쏜 살처럼 빠르다는 말이 맞아요.	세월이 마치 쏜살처럼 빠르다는 말이 맞아요.
이 년 동안 많이 배웠어요.	많이 배웠어요.
그렇지만 아직도 배울 것이 남았어요.	그렇지만 아직도 남아있어요.
대학원을 ( 법대 ) 시작하면 땀을 뻘뻘 흘리면서 열심히 공부해야지.	시작하면 열심히 공부해야지.
좋은 변호사로 좋은 취직할 수 있지요.	좋은 변호사로 좋은 취직을 할 수 있지요.
콩 심은데 콩 나고 팥 심은데 팥 난다고 말이 맞아요.	콩 심은 데 말이 맞아요.
법을 공부하면서 한국어도 계속 공부하고 싶어요.	한국어도 계속 공부하고 싶어요.
이렇게 해야지 한국말을 안 잊어버리지요.	이렇게 해야지 한국말을 안 잃어버리지요.
혹시 한국어학당에 다시 올 수 있으면 좋을텐데.	혹시 한국어학당이 다시 있으면 좋을 텐데.
어쨋든.	어쨌든.
이번 학기는 생각보다 더 재미있었어요.	이번 학기는 생각보다 더 재미있었어요.
고맙습니다!	고맙습니다!
제 생각에 가족이 인생에 제일 중요한 것 같습니다.	제 생각에 가족이 인생에 제일 중요한 것 같습니다.
친구들은 쉽게 사귈 수 있고 좀 힘들어지면 쉽게 헤어질 수 있지만 가족은 무슨 일이 생겨도 항상 옆에 있어 주고 피할 수도 없습니다.	친구들은 쉽게 사귈 수 있고 좀 힘들어지면 쉽게 헤어질 수 있지만 가족은 생겨도 항상 옆에 있어서 피할 수도 없습니다.
그러니까 친구들은 많이 사귈 수 있고 안 만나게 될 수도 있지만 아버지는 항상 아버지고 어머니는 항상 어머니고 형제는 항상 형제입니다.	그러니까 친구들은 많이 사귀어도 안 만나게 될 수도 있지만 아버지는 항상 아버지고 어머니는 항상 어머니고 형제는 항상 형제입니다.
제가 이 세상에서 제일 사랑한 사람들은 우리 가족입니다.	제가 가장 사랑하는 사람들은 우리 가족입니다.
부모님들 때문에 짜증이 난 일이 많이 있고 동생이랑 자주 싸우지만 저한테 소중한 사람들입니다.	부모님들 때문에 짜증이 난 일이 많이 있고 동생이랑 자주 싸우지만 저한테 소중한 사람들입니다.
한국에 있으니까 가족이 더 그립지만 가족이랑 너무 친하기 때문에 거리감이 느껴지지 않습니다.	한국에 있으니까 가족이 더 그립지만 가족이랑 너무 친하기 때문에 거리감을 느끼지 않습니다.
제가 제일 그리운 시간은 부모님들하고 함께 술을 마시는 것입니다.	제가 제일 그리운 시간은 부모님들하고 함께 술 마시는 것입니다.
술을 마시면서 재미있는 이야기를 많이 듣고 아버지랑 차츰차츰 친해지고 우리 어머니는 부엌에서 맛있는 안주를 만들고 있었다.	술 마시면서 재미있는 이야기 많이 듣고 아버지랑 차츰차츰 친해지고 우리 어머니는 부엌에서 마실 안주를 만들고 있었다.
좀 취하면 우리 아버지께서 동생을 붙들고 자꾸 한 잔 먹이려고 했습니다.	좀 취하면 우리 아버지가 동생을 부르고 자꾸 한 잔 먹이려고 했습니다.
우리 삶에 스트레스가 두 가지가 있습니다.	우리 삶에 스트레스가 있습니다.
해결할 수 있는 스트레스하고 해결할 수 없는 스트레스.	해결할 수 있는 스트레스와 해결할 수 없는
해결할 수 있는 스트레스를 해소하고 싶으면 그 스트레스의 원인을 깨달은 후에 해답을 찾아야 됩니다.	해결할 수 있는 스트레스를 해소하고 싶으면 그 스트레스의 원인을 깨달은 후에 해답을 찾아야 됩니다.
예를 들면 , 학교 성적이 좋지 않아서 스트레스가 쌓여 있으면 먼저 학교 성적을 개선할 거라고 마음을 먹어야 합니다.	예를 들면, 학교 성적이 좋지 않아서 스트레스가 쌓여 있으면 먼저 학교 성적을 개선하겠다고 마음을 먹어야 합니다.
그 후에 형편 없는 학교 성적의 원인을 찾아내야 돼요.	그 후에 형편없는 학교 성적의 원인을 찾아내야 돼요.
공부를 열심히 안하나?	공부를 열심히 안 하나?
공부를 열심히 하는데 실력이 나쁘나?	공부를 열심히 하는데 실력이 나쁘니?
그러면 공부법에 문제가 있나?	그러면 공부법에 문제가 있나?
수업 시간 때 집중하기가 어렵나?	때에 집중하기가 어렵나?
등 ... 원인을 찾았던 후에 가장 좋은 해답을 이행해야 돼요.	등 ... 원인을 찾은 후에 가장 좋은 해답을 이행해야 돼요.
혼자서 처리하지 못하면 유능한 사람한테 도움을 받아야 합니다.	혼자서 처리하지 못하면 유능한 사람에게 도움을 받아야 합니다.
현재 사회에서 살아가면서 스트레스가 쌓이는 것이 마련입니다.	현재 사회에서 살아가면서 스트레스가 쌓이는 것이 마련입니다.
모든 사람들은 근본적인 스트레스 수준을 경험합니다.	모든 사람은 근본적인 스트레스 수준을 경험합니다.
물론 지위마다 역할마다 스트레스의 정도하고 종류가 다르지요.	물론 지위마다 역할마다 스트레스 정도와 종류가 다르지요.
그런데 뭐니 뭐니 해도 인간들이 해결하고 해소할 수 없는 스트레스도 있습니다.	그런데 인간들은 해결하거나 해소할 수 없는 스트레스도 있습니다.
이런 스트레스는 힘이 미치지 않는 등 지배할 수 없는 원인 때문에 일어납니다.	이런 스트레스는 힘이 미치지 않는 등 지배할 수 없는 원인 때문에 발생합니다.
이런 스트레스를 잘 처리하지 않으면 몸하고 마음을 약화시킬 수 있습니다.	이런 스트레스를 잘 처리하지 않으면 몸과 마음을 약화시킬 수 있습니다.
원인을 해소할 수 없는 스트레스는 직접적인 해답이 없습니다.	원인을 해소할 수 없는 스트레스에는 직접적인 해답이 없습니다.
제일 좋은 방법은 그 스트레스에 신경을 쓰지 않고 기분 전환이 되는 활동을 해야 됩니다.	제일 좋은 방법은 그 스트레스에 신경을 쓰지 않고 기분 전환이 되는 활동을 하는 것입니다.
예를 들면 운동이든 미술이든 좋아하는 것을 해야 됩니다.	예를 들면 운동이든 미술이든 좋아하는 것을 해야 됩니다.
스트레스는 완전히 나쁜 것이 아님니다.	스트레스는 완전히 나쁜 것이 아닙니다.
적당한 정도로 우리 일생에 유익하지요.	적당한 정도로 우리 일생에 유익하지요.
스트레스가 인간들을 문제를 처리하게 만들고 게다가 모든 것을 더 잘하게 만듭니다.	스트레스가 인간들이 문제를 처리하게 만들고 게다가 모든 것을 더 잘하게 만듭니다.
그런데 스트레스가 너무나 지나치게 쌓이면 유해한 결과도 가능합니다.	그런데 스트레스가 너무 지나치게 쌓이면 유해한 결과도 가능합니다.
제가 왜 한국말을 배운지 가족 때문이에요.	저는 한국말을 배우는 이유가 가족 때문이에요.
미국에서 태어나고 해서 한국말이 서툴러요.	미국에서 태어나서 한국말이 서툴러요.
할머니와 할아버지를 방문할 때 엄마와 아빠가 있어서 한국말이 필요가 없었어요.	할머니와 할아버지께 방문할 때 엄마와 아빠가 있어서 한국말을 필요로 하지 않았어요.
그렇지만 대학교 때 부모님들께서 50대가 되었어요.	그렇지만 대학교 때 부모님이 50대가 되었어요.
그때 부모님께서 돌아가신다면 어떻게 하냐고 했어요.	그때 부모님이 돌아가시면 어떻게 하냐고 했어요.
친척집에 가면 어떻게 통할 거라고 생각했어요.	친척집에 가면 어떻게 생각했나요?
그래서 대학교를 졸업한 후에 부모님께서 나를 한국에 보냈어요.	그래서 대학교를 졸업한 후에 부모님이 나를 한국에 보냈어요.
작년에 전남에 살았어요.	작년에 전남에 살았어요.
시골이니까 , 외국인들이 별로 없었어요.	시골이니까 외국인들이 별로 없었어요.
처음에는 한국말을 많이 썼는데 시간이 지나가서 또 외국인과 사귀어서 영어만 썼어요.	처음에는 한국말을 많이 썼는데 시간이 지나면서 외국인 친구를 사귀어서 영어만 썼어요.
그랬더니 올해 연세 어학당에 왔어요.	그랬더니 올해 연세 어학당에 왔어요.
이젠 친척들과 얘기하는 것이 많이 좋아졌어요.	이제 친척들과 얘기하는 것이 많이 좋아졌어요.
제가 어렸을 때는 이런 생각을 했지요.	제가 이런 생각을 했지요.
누가 뭐래도 나는 꼭 의사나 변호사가 될 거라고 결정했습니다.	누가 뭐래도 나는 꼭 의사나 변호사가 되기로 결정했습니다.
그런데 커 가면서 생각이 달라졌습니다.	그런데 생각이 달라졌습니다.
변호사 일은 너무 재미가 없을 것 같고 , 의사는 되고 싶은데 과학은 싫고 그래서 어렸을 때 꿈을 포기했습니다 ".	너무 재미가 없을 것 같고, 의사는 되고 싶은데 과학은 싫고 그래서 꿈을 포기했습니다.
대학을 입학한 후 회계사가 되고 싶다는 생각이 들었습니다.	대학을 회계사가 되고 싶다는 생각이 들었습니다.
그런데 왠지 공부하는 게 그렇게 지겨울까요 ... 공부는 하기 싫고 노는 것만 좋아하다보니 전공은 역사로 선택했습니다.	그런데 왠지 그렇게 지겨울까요... 노는 것만 좋아하다 보니 전공은 역사로 선택했습니다.
그 중에서도 제일 쉬운 것 - 미국 역사 , 아직도 회계사가 되고 싶은 마음은 있어요.	그 중에서도 제일 역사, 아직도 회계사가 되고 싶은 마음은 있어요.
대학교에서 전공한 과목은 제가 하고 싶은 직업과 아마 관계도 없는 것은 알아요.	대학교에서 전공한 과목은 제가 하고 싶은 직업과 아마 관계도 알아요.
어학당에서 공부를 마친 후 미국에 돌아가서 대학원을 다니고자 합니다.	어학당에서 공부를 마친 후 미국에 돌아가서 대학원을 다니고자 합니다.
그리고 나서 회계사 자격증을 따고자 합니다.	그리고 나서 회계사 자격증을 따고자 합니다.
어학당에서 공부도 마치고 , 대학원도 다니다가 보면 의사도 못 되고 , 변호사도 못 되고 , 회계사도 못 되는 것Z 아닐까요 "?	어학당에서 공부도 마치고, 대학원도 다니다 보면 의사도, 변호사도, 회계사도 될 수 있지 않을까요?
평생 내 직업은 학생일까요?	평생 내 직업은 학생일까요?
한국에 오기 전에 한국 사람들이 고집을 부린다고 생각을 했습니다.	한국에 오기 전에 한국 사람들이 고집이 세다고 생각했습니다.
자기와 자기 가족에 대한 생각만 하는 선업관이 있었습니다.	자기와 자기 가족에 대해서만 생각하는 선입관이 있었습니다.
한국에 온 지 일 년 됐고 한국 친구들 몇 명하고 사귀어서 이런 선입관이 달라졌습니다.	한국에 왔고 한국 친구들을 사귀어서 이런 선입견이 달라졌습니다.
뉴욕에서 테러 사건이 일어났을 때 한국 친구들이 저한테 전화나 이메일을 해서 가족은 어떠냐 했을 때 마음이 따뜻해졌습니다.	뉴욕에서 테러 사건이 일어났을 때 저한테 전화나 이메일을 해서 가족은 어떤지 마음이 따뜻해졌습니다.
저에 대한 관심이 진짜 있나 보다고 생각을 했습니다.	저에 대한 관심이 진짜 생각을 했습니다.
한국말 공부를 할 때 너무 힘들면 친구 두 명이 한 시간 이상 걸렸는데 몇 번 우리 집이나 신촌 근처에 와서 큰 도움을 주었습니다.	한국말 공부가 너무 힘들었는데 친구가 한 시간 이상 걸려서 몇 번 우리 집이나 신촌 근처에 와서 큰 도움을 주었습니다.
처음 지난 방학이 끝나서 한국에 돌아올 때 요도 없고 바닥 위에 놓은 이불도 없어서 한 친구의 그의 친구한테 쓸 수 없는 매트를 빌려달라고 멀리서 우리집까지 가지고 왔습니다.	처음 끝나서 한국에 도착하지도 않았고 바닷가 위에 놓을 이불도 없어서 한 친구의 그의 친구에게 없는 매트를 빌려달라고 멀리서 우리 집까지 가지고 왔습니다.
제일 크게 도와 줄 때는 최근에 고민도 많고 기분이 나빠서 한국 친구가 저를 위해서 기도를 했습니다.	제일 큰 도움과 최근에 고민도 많고 기분이 나빠서 한국 친구가 저를 위해서 기도를 했습니다.
그때 그때 한국인의 신앙과 헌신적인 마음이 얼마나 큰지 발견합니다.	그때그때 한국인의 신앙과 헌신적인 마음이 얼마나 큰지 발견합니다.
어떤 때 이런 생각을 합니다.	이런 생각을 합니다.
한국 사람만큼 다른 사람을 사랑할 수 있으면 좋겠다고 생각합니다.	한국사람만큼 다른 사람이 있으면 좋겠다고 생각합니다.
대중 문화가 생활에 끼치는 영향에는 좋은 것들이 많습니다.	생활에 끼치는 영향에 좋은 것들이 많습니다.
특히 저는 스포츠와 노래를 좋아하기 때문에 항상 그것이 없으면 어떻게 내 생활을 바꿀까 생각해요.	특히 저는 스포츠와 노래를 좋아하기 때문에 항상 그것이 없으면 어떻게 내 생활이 바뀔까 생각해요.
그것이 없으면 내 인생도 허무해진다고 생각해요.	그걸 없애면 내 인생도 허무해진다고 생각해요.
대중 문화에 접하는 값이 차차 비싸진 반면에 스포츠와 노래는 복잡하게 돼서 각각 개인에 맞춰요.	접하는 값이 차차 비싸진 반면에 스포츠와 노래는 복잡해져서 각각 개인에 맞춰요.
그리고 심심한 시간이나 가벼운 일을 할 때나 이야기를 하면서 즐겁게 지낼 수 있어요.	그리고 심심한 시간이나 가벼운 일할 때나 이야기를 하면서 즐겁게 지낼 수 있어요.
그리고 쉽게 생각하면서 접을 수 있고 기분이 좋게 돼서 화가 날 때가 줄어요.	그리고 쉽게 생각하면서 접을 수 있고 기분이 좋아져서 화가 날 때가 줄어요.
눈으로 보고 마음에 기쁜 느낌이 생길 때 행복이나 세상을 볼 때 자기 눈에 보는 생각이 사람마다 다르기 때문에 행복을 찾을 때도 사람마다 다르다.	눈으로 보고 마음에 드는 기쁜 느낌이 행복이나 세상을 보는 생각이 사람마다 다르기 때문에 행복은 사람마다 다르다.
가족이랑 지내든 , 일을 많이 하든 , 다른 사람을 도와 주든 대부분은 행복을 찾고 싶으면 이 3 가지 중에서 하나를 선택한다.	가족이랑 지내든, 일을 하든, 다른 사람과 함께 하든 대부분은 행복을 찾고 싶으면 이 중에서 하나를 선택한다.
" 가족에게서 행복을 찾는 사람은 워낙 아이부터 가족이 중요하다고 생각하는 사람이다.	가족의 행복을 위해 아이부터 가족이 중요하다고.
일에서 스트레스가 산더미처럼 쌓여도 집에 돌아오면 따뜻한 느낌을 가질 수 있다.	일에서 스트레스가 산더미처럼 쌓여도 집에 돌아오면 따뜻한 느낌을 가진다.
이런 사람들은 가족 여행의 경험이 많다.	이런 사람들은 가족 여행의 경험이 많다.
가족이 중요하다고 생각하는 사람이 있다고 하면 반대도 있다.	가족이 중요하다고 생각하는 사람이 있다고 하면 반대도 있다.
뭐니 뭐니 해도 일이 제일이라고 하는 사람은 일 속에서 행복을 찾는다.	일이 제일이라고 하는 사람은 일 속에 행복을 찾는다.
이런 사람은 일을 열심히 하도록 승진하는 사람이다.	이런 사람은 일을 잘하는 사람이다.
원래 이런 사람들은 일에서 행복을 찾기 때문에 가족이 희생된다.	원래 이런 사람들은 일에서 행복을 찾기 때문에 가족이 희생된다.
일을 하면서 얼만큼 이룰 수 있는지로 행복을 잰다.	일을 하면서 알 만큼 행복을 잰다.
대부분이 3 번째를 선택하면 다른 사람을 도와 주는 행복을 찾는다.	대부분이 선택하면 다른 사람의 행복을 찾는다.
다른 사람을 많이 도와 주는 만큼 행복도 많아진다고 생각하는 사람이다.	다른 사람을 많이 행복하게 해주면 행복도 많아진다고 생각하는 사람이다.
이런 사람은 워낙 친절하고 틈틈이 다른 사람을 도와 준다.	이런 사람은 워낙 친절하고 틈틈이 다른 사람을 돕는다.
이런 사람은 다른 사람의 행복을 보고 자기 행복을 느낀다.	이런 사람은 다른 사람의 행복을 보고 자기 행복을 느낀다.
제 생각으로는 대부분은 행복하게 살고 싶으면 이 3 가지 중에서 하나를 한다.	제 생각은 대부분 행복하게 살고 싶으면 중에서 하나 한다.
그렇지만 행복을 찾으러 갈 때 하나만 살면서 중요한 것을 무시하면 안된다.	그렇지만 행복을 찾으러 하면서 중요한 것을 무시하면 안 된다.
예를 들면 일을 많이 해서 가족을 무시하든 가족과의 시간을 빼고 다른 사람의 행복에 관심이 없든 하나로 너무 경향이 가면 안된다.	일이나 가족을 무시하든 가족의 시간을 깨고 다른 사람의 행복을 하나로 너무 영향을 주면 안 된다.
세상을 볼 때 넓은 마음을 가지고 행복하게 살아야 한다.	세상을 볼 때 넓은 마음을 가지고 행복하게 살아야 한다.
살아가면서 스트레스를 받을 때가 많다.	살아가면서 스트레스 받을 때가 많다.
특히 21 시대가 되면서 생활이 더 복잡해지는 것 같다.	특히 되면서 생활이 더 복잡해지는 것 같다.
물론 기술이 발전되면서 , 옛날에 힘이 들었던 일들이 쉬워졌지만 , 그 발전도 우리에게 스트레스를 준다.	물론 기술이 발전되면서, 옛날에 힘이 들었던 일들이 쉬워졌지만, 그 발전도 우리에게 스트레스를 준다.
아마도 회사에서 스트레스를 받는 사람이 제일 많을 것이다.	아마도 회사에서 스트레스를 받는 사람이 가장 많을 것이다.
부장님께서 야단을 치거나 , 일이 너무 많거나 , 일이 너무 어려울 때 , 스트레스가 쌓인다.	부장님께서 일이 너무 많거나, 일이 너무 어려울 때, 스트레스가 쌓인다.
그러나 스트레스 해소법들을 사용하면 언제나 이 피로를 풀 수 있다.	그러나 스트레스 해소법들을 사용하면 언제나 이 피로를 풀 수 있다.
첫 번째는 잠을 제시간에 잘 자야한다.	첫 번째는 잠을 제시간에 잘 자야 한다.
될 수 있는 대로 매일 똑같은 시간에 자는 게 좋다.	될 매일 똑같은 시간에 좋다.
그리고 하루에 7 - 8 시간 자는 게 좋다.	그리고 하루에 좋다.
두 번째는 운동이다.	두 번째는 운동이다.
가벼운 운동이라도 하는 게 좋다.	가벼운 운동이라도 좋다.
몸도 건강해지고 마음도 건강해진다.	몸도 건강해지고 마음도 건강해진다.
특히 좋아하는 운동을 하면 더 좋다.	특히 좋아하는 게 더 좋다.
스트레스를 잊어버릴 수 있기 때문에 운동을 싫어하면 , 다른 즐길 수 있는 취미를 만드는 것도 스트레스 해소법의 하나다.	스트레스를 잊어버릴 수 있기 때문에 운동을 싫어하면, 다른 즐길 수 있는 취미를 만드는 것도 스트레스 해소법의 하나이다.
또는 음악이 도움을 줄 수 있다.	또는 음악이 도움을 줄 수 있다.
음악을 들으면서 모든 힘든 일을 잠깐이나마 잊어버릴 수 있기 때문이다.	음악을 들으면서 모든 힘든 일을 잠깐이라도 잊어버릴 수 있기 때문이다.
음악의 특징은 사람의 마음을 현실에서 떠날 수 있게끔 한다.	음악의 특징은 사람의 마음을 현실에서 떠날 수 있게 한다.
신이 나는 음악을 들으면 자기도 모르게 기분이 좋아진다.	신이 나는 음악 들으면 자기도 모르게 기분이 좋아진다.
잠을 자면서 음악을 들어도 효과가 있단다.	잠을 자면서 음악을 들어도 효과가 있단다.
사람마다 스트레스를 푸는 방법이 다르다.	사람마다 스트레스 푸는 방법이 다르다.
그래서 직접 이것저것 경험을 해 보며 자기만의 스트레스 해소법을 찾을 수 있다.	그래서 직접 이것저것 경험을 해 보며 자기만의 스트레스 해소법을 찾을 수 있다.
최근 20 년 동안 사회가 아주 많이 변했습니다.	최근에 사회가 아주 많이 변했습니다.
역사상 제일 믾이 변한 기간인 것 같습니다.	역사상 제일 많이 변한 기간 같습니다.
주요 인원은 기술개발이라고 생각합니다.	주요 인원은 기술 개발이라고 생각합니다.
기술이 아주 빨리 발전돼서 요즘 사람들은 텔레비전과 인터넷 등을 통해서 정보와 지식을 풍부하게 얻을 수 있습니다.	기술이 아주 빨리 발전해서 요즘 사람들은 텔레비전을 통해서 정보와 지식을 풍부하게 얻을 수 있습니다.
그러니까 옛날보다 요즘 시대 사람들은 사고방식이 더 빨리 발전하게 된다고 생각합니다.	그러니까 옛날보다 요즘 시대 사람들은 사고방식을 더 빨리 발전한다고 생각합니다.
제 생각이 사실이면 세대차이로 사고방식의 거리가 더 멀어진다.	제 생각이 사실이면 세대 차이로 인한 사고방식의 거리가 더 멀어진다.
그래서 현대 사회에서 부모와 자식들이 서로 이해하기 더 힘들어졌습니다.	그래서 현재 사회에서 부모와 자식들이 서로 이해하기 더 힘들어졌습니다.
부모와 자식들이 서로 더 잘 이해하게 되려면 토론과 대화가 많이 필요하다고 생각합니다.	부모와 자식들이 서로 더 잘 이해하려면 토론과 대화가 많이 필요하다고 생각합니다.
옛날 한국에서는 부모와 자식들은 사회에 대한 토론을 많이 안했지만 현대 사회에서는 필요합니다.	옛날 한국에서는 부모와 자식들이 사회에 대한 토론을 많이 안 했지만 현재 사회에서는 필요합니다.
아니면 세대 차이가 더 심해질 것입니다.	아니면 세대 차이가 더 심해질 것입니다.
저는 의과 대학 학생인데도 저의 건강 관리법이 안 좋다고 생각합니다.	저는 학생인데도 저의 건강 관리법에 대해 생각합니다.
어떻게 해야하는 줄 몰라서 아니라 젊어서 그런지 건강 관리 잘 안합니다.	어떻게 몰라서가 아니라 젊어서 그런지 건강 관리를 잘 안 합니다.
3학년 때Z 병원에서 환자한테 운동을 꼭 해야 된다고 항상 추천했습니다.	병원에서 환자에게 운동을 꼭 해야 한다고 항상 추천했습니다.
그런데 평소에 저는 한 달에 두어 번 운동할 뿐이에요.	그런데 평소에 저는 운동할 뿐이에요.
지난 달에는 운동할 겸해서 마을 버스 타는 대신에 신촌에서 기숙사까지 걷기만 했어요.	지난달은 마을버스를 타는 대신에 신촌에서 기숙사까지 걷기만 했어요.
앞으로 계속 할 수 있었으면 좋겠습니다.	앞으로 계속 좋겠습니다.
어렸을 때Z 어머니 덕분에 밥을 제대로 먹었습니다.	어머니 덕분에 밥을 제대로 먹었습니다.
대학교 때도 좋은 학생식당이 있었으니까 영양 있는 음식을 보통 때 먹을 수 있었습니다.	좋은 학생식당이 있었으니까 음식.
그렇지만 의대 때Z 학생식당 같은 곳이 없어서 날마다 피자라든지 라면이라든지 간단한 음식만 먹었는데요.	그렇지만 학생식당 같은 곳이 없어서 날마다 피자라든지 라면이라든지 간단한 음식만 먹었는데요.
한국에 와서 건강을 위해서 밥을 제대로 먹고자 해서 애를 쓰고 그렇게 하도록 합니다.	한국에 와서 건강을 위해 밥을 제대로 먹고자 애를 쓰고 그렇게 하도록 합니다.
미술사 학생이라서 이번 학기에 한국 미술과 건축을 보고 싶어요.	미술사 학생이라서 이번 학기에 한국 미술과 건축을 보고 싶어요.
한국에서 볼 만한 것으로는 경주가 제일이에요.	한국에 볼 만한 것으로는 경주가 제일이에요.
하지만 경주에 갈 때 , 거기 있는 국립박물관이 공사 중이었어요 ".	하지만 경주에 갈 때, 거기 있는 국립박물관이었어요.
그래서 한 주말에 이번 학기에 그 박물관의 전람회를 무조건 보고 싶어요.	그래서 한 주말에 이번 학기에 그 박물관의 전람회를 무조건 보고 싶어요.
또 , 부여라든가 부산이라든가 다른 도시를 방문한다고 생각하고 있어요.	떠나, 부여라든가 부산이라든가 다른 도시를 방문한다고 생각하고 있어요.
이번 학기에 한국 친구를 사귀고 싶어요.	이번 학기에 한국 친구를 사귀고 싶어요.
여행을 게다가 한국에 처음 왔을 때Z 한국말이 서툴러서 한국 사람이 저와 통할 때 영어로 할 뿐이에요.	여행을 게다가 한국에 처음 왔을 때 한국말 서툴러서 한국 사람이 저한테 통할 때 영어로 할 뿐이에요.
한국 사람들이 영어를 연습하려고 하는 것은 이해할 수 있지만 , 제가 한국에 오는 이유는 한국말을 배우게예요.	한국 사람들은 영어를 연습하려고 하는 것은, 제가 한국에 오는 이유는 한국말을 배우기 위해서예요.
초등학생처럼밖에 대화할 수 없지만 시간이 지날수록 더 깊은 느낌을 표현할 수 있다고 생각해요.	초등학생밖에 대화할 수 없지만 시간이 지날수록 더 깊은 느낌을 표현할 수 있다고 생각해요.
그런데 이 세상에서 이해를 잘 주는 사람을 찾는 것은 보통 일이 아니에요.	그런데 이 세상에 이해를 잘 주는 사람을 찾기는 것은 아니에요.
유승준 입국 금지를 어떻게 생각해요?	뉴스증 어떻게 생각해요?
여행을 가기 전에 물론 어디에 갈건지 돈을 얼마나 낼건지 결정해야 해요.	여행을 가기 전에 물론 돈을 얼마나 낼 건지 결정해야 해요.
바닷가며 산이며 사람이 별로 없는 곳에 가면 기뻐요.	바닷가나 산에 가면 기뻐요.
많은 관광객들이 가니만큼 하와이가 좋은 곳 같아요.	많은 관광객들이 가는 만큼 같아요.
붐빈 공항에 가야 하면 짜증이 나요.	붐비는 공항에 짜증이 나요.
일본 사람은 물론이고 한국 사람도 미국에 가자면 비자가 필요해요.	미국에 가려면 비자가 필요해요.
하와이에 가면 와이키키가 사람으로 꽉차 있으니까 조심하세요.	와이키키가 사람으로 꽉 차 있으니까 조심하세요.
하와이에는 폭설이 없지만 폭우하고 폭풍 그리고 가끔은 태풍도 와요.	하와이에는 폭설은 없지만 폭우와 폭풍 그리고 가끔은 태풍도 와요.
하와이의 날씨가 너무 좋지만 단풍을 틀림없이 볼 수 없어요.	하와이의 날씨가 너무 좋지만 단풍이 틀림없이.
미국 주 중에 하와이가 제일 아름답다고들 한답니다.	하와이가 제일 아름답다고들 한답니다.
한국의 겨울이 이렇게 추울 줄 알았더라면 하와이에 있을걸 가치관이란 나이에 따라서 차이가 나는 것 같습니다.	이렇게 알았더라면 하와이에 있을걸. 가치관이란 나이에 따라서 차이가 나는 것 같습니다.
어린아이에게 아이스크림과 셰익스피어의 맥베드 초판 중에 무엇을 원하냐고 물으면 예상 대답은 명백합니다.	어린아이에게 아이스크림과 셰익스피어의 맥베스 초판 중에 무엇을 원하냐고 물으면 예상 대답은 명백합니다.
사람이 살면서 성숙해질 때까지 수많은 성격 변화를 경험하지요.	사람이 살면서 수많은 성격 변화를 경험하지요.
한때 진짜 소중하고 가치 있어 했던 게 한번에 갈증이 나고 유치해 보일 수 있지요.	한데 진짜 소중하고 가치 있어 한템에.
자기가 좋아하던 음악의 유파를 생각해 보세요.	자기가 좋아하던 음악의 유파를 생각해 보세요.
누가 저에게 이런 말을 해 주었지요.	누가 저에게 이런 말을.
문신을 원하면 한 서른 살 때까지 기다리라고.	문신을 원하면 한 대까지 기다리라고.
그때까지는 후회를 피할 수 없으니까.	그때까지는 후회를 피할 수 없으니까.
저는 어렸을 때는 미국에서 자라서 한국말을 잘 못했어요.	저는 미국에서 자라서 한국말을.
나이가 드니까 한국말에 호기심도 생기고 , 배우고 싶은 마음도 생겼어요.	나이가 드니까 한국말에 호기심도 생기고, 배우고 싶은 마음이 생겨서요.
어릴 때부터 한국말을 못하면 NONE 바보라고 많이 들어보기도 했어요.	한국말을 못하면, 바보라고 많이 들어보기도 했어요.
그것보다도 , 저한테 더 소중한 것은 나의 한국 아이덴티티를 찾는 것이다.	그것보다도, 저한테 더 소중한 것은 나의 한국 아이덴티티를 찾는 것이다.
나는 크면서 한국말을 몰라서 내가 바보란 것을 스스로 느꼈다.	나는 크면서 한국 말을 몰라서 내가 바보라는 것을 스스로 느꼈다.
나의 얼굴 색깔이 노랗다는 것 때문이다.	나의 얼굴 색깔이 노랗다는 것 때문이다.
미국에서 자라도 나는 완벽한 미국 사람은 못된다.	미국에서 자라도 나는 완벽한 못된다.
그것은 바로 , 나의 부모님한테서 받은 마음 자세와 , 얼굴 색깔과 한국 체질이다.	그것은 바로 나의 부모님한테서 받은 마음 자세와 얼굴 색깔하고 한국 체질이다.
그레서 나는 한국말을 배우고 싶다.	그래서 나는 한국말을 배우고 싶다.
제가 한국 사람이기 때문에 한국어를 알아야죠.	제가 한국 사람이기 때문에 한국어를 알아야죠.
제가 미국에서 태어났는데도 부모님께서는 한국에서 오셨어요.	제가 미국에서 태어났는데도 부모님이 한국에서 오셨어요.
그래서 우리 부모님을 더 잘 이해하기 위해서 한국어와 한국 전통을 직접 경험했으면 좋은 것뿐이겠죠.	그래서 우리 부모님을 더 잘 이해하기 위해서 한국어와 한국 전통을 직접 경험했으면 좋은 것뿐이겠죠.
그것뿐이 아니라 다른 이익도 많죠.	그것뿐만 아니라 다른 이익도 많죠.
한국말을 배우면 한국 친구도 사귈 수 있으니 참 좋아요.	한국말을 배우면 한국 친구도 사귈 수 있으니 참 좋아요.
한국 사람들이 어떤 면에서는 미국 사람보다 좋은 점이 있어요.	한국 사람들이 어떤 면에서는 미국 사람보다 좋은 점이 있어요.
제 경험에는 한국 사람들이 더 진실하고 훌륭한 사람들이에요.	제 경험으로는 한국 사람들이 더 진실하고 훌륭한 사람들이에요.
그렇지만 물론 서양 사람들한테서 많이 배울 수도 있죠.	그렇지만 물론 많이 배울 수도 있죠.
하여튼 한국어를 배우면 , 일에 대해 , 많은 좋은 기회도 나타날 거예요.	하여튼 한국어를 배우면, 일에 대해 많은 좋은 기회도 생깁니다.
마지막으로는 제가 혹시 한국 여자 친구를 사귈 수 있을까 생각도 들어요.	마지막으로는 제가 혹시 한국 사람을 사귈 수 있을까 생각도 들어요.
사생활 침해에 대해서 좋은 점도 많지만 나쁜 점도 많아서 고민이다.	사생활 좋은 점도 많지만 많아서 고민이다.
특히 아이와 부모 사이에 이런 일이 많다.	특히 아이와 부모 사이에 이런 일이 많다.
부모 입장에서는 자식을 부모가 자식+의 사생활 침해를 하는 이유는 자식이 잘되기 위해서 하는 것이다.	부모 입장에서는 부모가 자식의 사생활을 침해하는 이유는 자식이 잘되기 위해서이다.
보통 아이들을 옆에서 간섭을 하는 이유는 자식이 잘되기 위해서 하는 것이다.	보통 부모가 아이들에게 간섭을 하는 이유는 자식이 잘되기 위해서이다.
어쩔 땐 침해를 할수록 야단을 맞기 싫어서 아이들은 해야 하는 일들을 해야 하는 일들을 더 빨리 처리한다.	어쩔 땐 질책을 받을까 봐 아이들은 해야 하는 일들을 더 빨리 처리한다.
그리고 어떤 아이들은 이렇게 생각한다.	위의 글을 읽고 맞춤법 오류를 수정한 글만 출력해 줘.
부모가 침해를 안 하면 자기는 사랑을 안 받는 것 같아.	부모가 침해를 안 하면 자기는 사랑을 안 받는다.
그래서 다른 나쁜 길로 빠질 수도 있다.	그래서 다른 나쁜 길로 빠질 수도 있다.
그러니까 간섭을 해야 아이들은 올바르게 살 수 있다.	그러니까 간섭을 해야 아이들은 올바르게 자란다.
그러나 아이들도 자기가 해야하는 일을 스스로 알고 있다.	그러나 아이들도 자기가 해야 하는 일을 스스로 알고 있다.
원래 사람은 잔소리를 들으면 무슨 일이든 하기가 싫어진다.	원래 사람은 잔소리를 들으면 하기 싫어진다.
자기가 해야 하는 일을 하려고 생각했는데 잔소리를 듣자마자 괜히 하기가 싫어 해야 하는 일을 안 한다.	자기가 일을 하려고 생각했는데 잔소리를 듣고 나니 괜히 하기가 싫어졌다.
" 또한 , 부모님들이 간섭을 너무 많이 하면 아이가 잔소리를 피하려고 거짓말을 하게 된다.	"또한, 부모님들이 간섭을 너무 해서 아이가 잔소리를 피하려고 거짓말을 한다."
그래서 부모님들은 침해를 해야 하는지 안 해야 하는지 고민을 한다.	그래서 부모님들은 치매를 해야 하는지 안 해야 하는지 고민을 한다.
부모님들은 자식에 대한 욕심과 사랑 때문에 간섭을 하지만 아이들은 이것을 모르고 그냥 잔소리로 듣는다.	부모님들은 자식에 대한 욕심과 사랑 때문에 간섭을 하지만 아이들은 이것을 모르고 그냥 잔소리로 들린다.
그러니까 부모는 간섭을 적당히 하면 이 문제를 풀 수 있다.	그러니까 부모는 간섭을 적당히 하면 이 문제를 풀 수 있다.
꼭 해야한 얘기만 아이들한테 알려 주고 나머지는 아이한테 맡길 수밖에 없다.	꼭 해야 할 얘기만 아이들한테 나머지는 아이한테 맡길 수밖에 없다.
사람들은 중요한 거를 기다릴 때마다 마음이 초조해요.	사람들은 마음이 초조해합니다.
예를 들면 , 시험 결과나 아니면 기대하는 소식을 듣고 싶은데.	아니면 기대하는 소식을 듣고 싶을 텐데.
내 경우에는 학교에 붙는 시험 결과를 기다릴 때 그렇거든.	내 경우에는 학교에 붙는 거거든.
나는 미국으로 대학을 가기 위해 , 준비를 많이 했다.	나는 미국으로 대학 준비를 많이 했다.
밤새 공부도 하고 , 굶으면서도 공부를 했다.	밤새 공부도 하고, 굶으면서도 공부를 했다.
시험을 보기 전에 , 너무 초조해서 가만히 못 있고 , 여기저기 갔다.	시험 보기 전에 너무 초조해서 가만히 여기저기 갔다.
하지만 이것은 시험 후하고 비교를 하면 아무 것도 아니다.	하지만 이것은 시험 후 아까 비교를 하면 아니다.
점수를 알아보러 가는데 , 내 온 몸이 떨렸다.	점수 알아보러 가는데, 내 온몸이 떨렸다.
내 인생이 이 시험에 의지하다고 생각을 했다.	내 인생이 이 시험에 달려 있다고 생각했다.
그래서 전화를 손에다가 들고 , 안절부절 못했다.	그래서 전화는 손에다가 들고, 안절부절못했다.
전화를 할까 말까 생각을 했다.	전화를 할까 말까 생각했다.
내 마음이 변덕스러웠다.	내 마음이 변덕스러웠다.
그러나 , 나는 결심했다.	그러나, 나는 결심했다.
전화를 해가지고 , 점수를 알아보았다.	전화를 해서, 점수를 알아보았다.
결국은 내가 원하는 점수가 아니었지만 , 만족을 했다.	결국은 내가 원하는 점수가 아니지만, 만족했다.
저는 재미 교포입니다.	저는 재미교포입니다.
저는 한국에서 태어나서 네 살 때 미국으로 이민 갔어요.	저는 한국에서 태어나서 미국으로 이민 갔어요.
아무리 미국에서 오랫동안 살아도 저는 한국 사람같이 생겨서 한국에 온 거예요.	아무리 미국에서 오랫동안 살아도 저는 한국 사람 같이 생겨서 한국에.
제 이유는 아주 간단합니다.	그 이유는 아주 간단합니다.
저는 이 어학당에 다니면서 기본 문법과 듣기 , 읽기 , 특히 쓰기를 배우고 싶어요.	저는 이 어학당에 다니면서 기본 문법과 듣기, 읽기, 특히 쓰기를 배우고 싶어요.
하지만 무엇보다도 한국 문화를 배우고 싶어요.	하지만 무엇보다도 한국 문화를 배우고 싶어요.
처음에는 익숙해지지 않아서 한국 생활이 힘들었지만 , 지금은 아주 재미있고 , 좋아요.	처음에는 익숙해지지 않아서 한국 생활이 힘들었지만, 지금은 아주 재미있고, 좋아요.
벌써 석 달이 지났어요.	벌써 지나쳤어요.
완벽하지 않지만 , 저는 한국말을 처음보다 더 잘 합니다.	완벽하지 않지만, 저 한국말을 처음보다 더 잘합니다.
그리고 , 믿을 수 없지 제가 쓰는 것과 읽는 것도 많이 늘었어요.	그리고, 제가 쓰는 것과 읽는 것도 많이 늘었어요.
이번 학기에 많이 늘이고 싶어요.	이번 학기에 많이 늘리고 싶어요.
열심히 공부할 겁니다.	열심히 공부할 겁니다.
제가 한국에 온 이유는 제 미래에 꼭 도움이 될 거라고 생각합니다.	제가 한국에 온 이유는 제 미래에 꼭 도움이 될 거라고 생각합니다.
제 꿈은 국제 변호사입니다.	제 꿈은 국제변호사입니다.
그리고 저는 한국 사람처럼 말하고 싶어요.	그리고 저는 한국 사람처럼 말하고 싶어요.
이것은 제 큰 꿈입니다.	이것은 제 큰 꿈입니다.
